SA2_CODE,EDU_DIPLOMA,EDU_BACHELOR,EDU_CERT_I_II,EDU_CERT_III_IV,EDU_CERT,EDU_CERT_ALL,EDU_GRAD_DIP_CERT,EDU_POSTGRAD_DEGREE,EDU_POSTGRAD,EDU_OTHER
101021007,272,401,33,557,779,1369,63,166,229,547
101021008,548,586,72,1245,1602,2919,121,200,321,618
101021009,797,1288,126,1500,1928,3554,213,462,675,1022
101021010,385,658,65,630,818,1513,86,289,375,341
101021011,1459,2079,144,2251,2942,5337,464,915,1379,1638
101021012,1093,1501,96,1579,2010,3685,325,741,1066,618
101031013,140,153,27,361,481,869,19,17,36,234
101031014,411,504,77,1105,1449,2631,94,111,205,974
101031015,232,314,34,537,720,1291,27,81,108,387
101031016,555,721,93,1366,1769,3228,104,175,279,731
101041017,467,439,101,1310,1768,3179,101,89,190,924
101041018,609,670,109,1373,1904,3386,132,171,303,978
101041019,531,765,102,1283,1635,3020,139,159,298,909
101041020,646,812,129,1576,2098,3803,163,184,347,889
101041021,255,352,19,568,728,1315,85,80,165,354
101041022,0,0,0,0,0,0,0,0,0,0
101041023,188,167,48,463,649,1160,22,28,50,467
101041024,247,253,42,672,890,1604,52,63,115,319
101041025,806,970,118,1789,2448,4355,201,205,406,1163
101041026,603,669,91,1433,1941,3465,131,180,311,826
101041027,648,777,116,1549,2110,3775,167,197,364,1130
101051539,1561,1421,276,3659,4816,8751,247,343,590,2811
101051540,906,896,124,2190,2880,5194,162,246,408,1393
101061541,427,626,65,939,1287,2291,88,135,223,668
101061542,927,1500,87,1514,1944,3545,317,583,900,912
101061543,550,646,126,1634,2159,3919,86,90,176,1016
101061544,454,480,95,1063,1433,2591,59,83,142,828
102011028,704,1068,58,1052,1420,2530,158,283,441,452
102011029,964,1262,92,1725,2328,4145,203,323,526,759
102011030,390,435,57,741,1038,1836,47,113,160,554
102011031,1165,1544,120,1909,2603,4632,202,419,621,1378
102011032,1577,2323,196,2729,3694,6619,238,582,820,1799
102011033,545,508,77,1062,1390,2529,64,118,182,494
102011034,544,660,72,1222,1718,3012,86,151,237,559
102011035,545,652,70,1160,1496,2726,90,157,247,383
102011036,665,818,72,1374,1761,3207,110,177,287,460
102011037,593,743,59,954,1278,2291,104,213,317,414
102011038,621,680,63,1306,1715,3084,101,128,229,465
102011039,1218,2004,137,1880,2591,4608,262,534,796,886
102011040,1726,1729,281,3889,5238,9408,239,511,750,2317
102011041,885,1303,77,1486,1979,3542,187,300,487,629
102011042,996,1097,162,2157,2895,5214,162,312,474,1409
102011043,920,948,152,1783,2345,4280,105,214,319,1180
102021044,1537,1579,255,3879,5024,9158,185,276,461,1983
102021045,568,360,151,2015,2557,4723,41,43,84,778
102021046,619,456,130,1857,2378,4365,64,84,148,837
102021047,1164,1107,175,2890,3774,6839,159,226,385,1008
102021048,1242,979,273,3797,4946,9016,137,168,305,2553
102021049,280,330,27,530,732,1289,40,82,122,352
102021050,644,490,141,2095,2699,4935,55,82,137,991
102021051,427,544,49,806,1035,1890,57,132,189,298
102021052,342,277,68,1253,1581,2902,34,48,82,371
102021053,1039,1043,173,2458,3282,5913,159,226,385,1655
102021054,619,537,111,1754,2260,4125,85,89,174,1164
102021055,376,471,65,849,1101,2015,56,105,161,416
102021056,1116,943,165,2503,3273,5941,127,210,337,890
102021057,536,477,112,1426,1877,3415,66,91,157,854
103011058,1503,2380,305,3552,4784,8641,381,630,1011,2723
103011059,698,878,139,1872,2434,4445,151,173,324,833
103011060,493,577,75,1187,1580,2842,148,161,309,1036
103011061,238,246,76,693,992,1761,25,52,77,665
103021062,293,342,91,772,1042,1905,57,29,86,868
103021063,441,497,106,1396,1859,3361,73,61,134,987
103021064,345,387,68,842,1124,2034,32,48,80,544
103021065,535,608,140,1503,2016,3659,75,81,156,1174
103021066,194,226,57,519,720,1296,27,24,51,455
103021067,532,651,164,1756,2290,4210,80,103,183,1263
103021068,196,179,32,519,685,1236,24,44,68,415
103021069,254,322,72,828,1132,2032,37,40,77,813
103031070,637,653,165,2135,2801,5101,115,115,230,1775
103031071,518,458,113,1479,1915,3507,66,108,174,1193
103031072,656,917,161,1986,2562,4709,116,124,240,1234
103031073,152,165,50,555,746,1351,16,28,44,488
103031074,537,602,129,1722,2256,4107,85,108,193,1451
103031075,0,0,0,0,0,0,0,0,0,0
103041076,418,541,80,1186,1605,2871,93,110,203,731
103041077,1200,1765,249,2653,3616,6518,249,432,681,2004
103041078,1363,2009,218,3133,4056,7407,312,510,822,1350
103041079,827,1088,137,1815,2482,4434,123,267,390,1008
104011080,979,1064,279,2967,4022,7268,153,180,333,2175
104011081,916,848,174,2775,3683,6632,146,182,328,1754
104011082,1082,1184,194,2873,3891,6958,188,206,394,1830
104021083,503,782,66,789,1092,1947,108,192,300,494
104021084,1289,1386,281,2729,3660,6670,173,243,416,1708
104021085,718,949,152,1497,2077,3726,104,199,303,1466
104021086,291,309,53,719,933,1705,63,73,136,387
104021087,200,244,43,511,678,1232,44,43,87,361
104021088,791,1101,93,1471,1931,3495,154,227,381,628
104021089,1416,1735,284,3233,4496,8013,271,328,599,1508
104021090,326,437,51,833,1110,1994,60,74,134,490
104021091,894,1096,129,1941,2548,4618,165,157,322,1238
105011092,188,231,63,338,517,918,16,30,46,701
105011093,173,248,49,751,903,1703,36,41,77,582
105011094,169,232,46,445,623,1114,14,20,34,665
105011095,223,306,55,617,824,1496,37,34,71,632
105011096,310,345,72,688,918,1678,36,52,88,917
105021097,816,895,229,2880,3697,6806,177,194,371,2109
105021098,107,93,34,257,368,659,18,6,24,470
105031099,400,488,121,1106,1492,2719,63,83,146,1034
105031100,551,822,144,1693,2159,3996,149,173,322,922
105031101,1034,1723,183,2713,3495,6391,248,360,608,1469
105031102,506,624,113,1309,1729,3151,69,119,188,832
105031103,343,506,71,1000,1283,2354,57,65,122,588
105031104,202,252,51,634,834,1519,18,33,51,513
105031105,330,415,81,935,1188,2204,44,38,82,734
105031106,448,403,113,1190,1591,2894,53,70,123,1787
106011107,648,681,128,1981,2486,4595,82,132,214,825
106011108,1017,828,354,3837,4908,9099,116,124,240,2726
106011109,519,547,94,1439,1888,3421,91,147,238,930
106011110,666,660,91,1601,2073,3765,86,135,221,870
106011111,785,568,235,3408,4231,7874,78,86,164,1526
106011112,868,987,225,3150,4002,7377,135,179,314,1137
106011113,269,294,45,921,1142,2108,22,49,71,658
106021114,441,499,96,1141,1477,2714,51,119,170,588
106021115,2025,2273,330,4662,6032,11024,314,519,833,1930
106021116,614,910,88,1260,1612,2960,124,231,355,459
106021117,1293,1196,310,4321,5346,9977,171,245,416,1614
106021118,719,673,99,1984,2446,4529,109,143,252,403
106031119,424,431,52,1154,1438,2644,69,85,154,630
106031120,455,302,96,1313,1724,3133,47,66,113,660
106031121,1810,1728,241,3752,5138,9131,236,467,703,2336
106031122,689,588,193,2440,3093,5726,70,116,186,1273
106031123,428,485,58,1068,1387,2513,63,114,177,346
106031124,437,383,67,945,1346,2358,62,94,156,525
106031125,1050,802,187,2681,3387,6255,117,165,282,1265
106041126,527,571,166,2107,2612,4885,63,123,186,1196
106041127,225,183,44,739,926,1709,18,17,35,386
106041128,343,426,61,976,1199,2236,48,64,112,602
106041129,448,466,95,1376,1797,3268,57,70,127,990
107011131,1498,1296,292,4458,5731,10481,201,297,498,1626
107011132,713,632,91,1615,2057,3763,94,183,277,457
107011133,0,0,0,0,0,0,0,0,0,3
107011134,1132,1614,157,2432,3248,5837,234,485,719,1270
107011545,783,642,160,2071,2747,4978,74,149,223,1166
107011546,496,497,121,1371,1872,3364,54,123,177,956
107011547,278,214,50,751,973,1774,33,74,107,455
107021135,0,0,0,0,0,0,0,0,0,0
107031136,1001,888,142,2897,3660,6699,130,179,309,900
107031137,417,296,104,1371,1808,3283,36,38,74,695
107031138,761,1012,85,1141,1599,2825,181,327,508,644
107031139,581,791,51,1029,1352,2432,148,202,350,310
107031140,717,1143,53,1104,1550,2707,200,311,511,775
107031141,1359,1505,156,2909,3745,6810,194,378,572,1052
107031142,758,613,126,1873,2447,4446,88,143,231,697
107031143,1152,897,255,3443,4539,8237,149,176,325,2061
107041144,1645,2569,214,3014,4104,7332,342,1018,1360,1461
107041145,1151,1406,167,2567,3379,6113,185,415,600,1114
107041146,1649,2943,205,2762,3854,6821,411,1246,1657,1125
107041147,748,1028,63,1460,1894,3417,158,338,496,626
107041148,960,1968,80,1397,1823,3300,360,923,1283,667
107041150,1633,2269,174,3023,4040,7237,393,839,1232,1285
107041548,1071,2486,125,1599,2274,3998,305,996,1301,1957
107041549,1218,2489,175,1935,2653,4763,290,1019,1309,1158
108011151,297,264,49,796,1042,1887,30,47,77,478
108011152,1012,982,193,2362,3281,5836,153,185,338,1622
108011153,417,376,63,1251,1610,2924,46,110,156,633
108011154,375,260,78,1117,1479,2674,43,34,77,875
108021155,640,604,235,2209,3024,5468,84,74,158,2392
108021156,557,576,109,1660,2155,3924,85,103,188,1069
108021157,282,288,77,813,1096,1986,55,66,121,521
108021158,419,365,83,1119,1539,2741,63,44,107,902
108021159,501,587,113,1342,1826,3281,86,89,175,769
108021160,316,308,54,987,1303,2344,35,41,76,543
108031161,20,36,0,83,101,184,0,3,3,42
108041162,1223,1205,225,3157,4244,7626,197,228,425,1767
108041163,2363,2961,337,4460,6152,10949,472,711,1183,2447
108041164,1302,1163,206,2797,3793,6796,142,255,397,1961
108041165,392,388,86,1014,1322,2422,81,73,154,609
108041166,679,699,151,2000,2625,4776,112,99,211,1069
108051167,325,347,57,783,1125,1965,44,44,88,495
108051168,855,902,118,1943,2680,4741,156,211,367,972
108051169,1194,1018,318,3151,4441,7910,162,184,346,2287
108051170,840,742,178,2263,3034,5475,132,125,257,1468
108051171,279,270,87,898,1227,2212,41,41,82,494
109011172,1179,1708,200,2485,3171,5856,286,356,642,957
109011173,617,715,127,1721,2197,4045,149,131,280,906
109011174,811,1322,96,1350,1805,3251,248,384,632,1150
109011175,823,858,126,1882,2440,4448,121,151,272,1058
109011176,823,765,193,2577,3286,6056,112,157,269,1454
109021177,158,141,34,392,479,905,15,15,30,396
109021178,342,357,64,886,1113,2063,54,48,102,788
109021179,149,155,38,457,585,1080,24,19,43,499
109031180,316,304,62,942,1191,2195,43,40,83,618
109031181,367,352,79,1067,1409,2555,63,46,109,808
109031182,405,459,76,1158,1470,2704,74,69,143,958
109031183,420,410,63,938,1200,2201,55,50,105,822
109031184,343,452,50,932,1151,2133,58,59,117,599
109031185,532,575,87,1512,1937,3536,78,67,145,1317
110011186,1389,2836,266,2653,3694,6613,513,1613,2126,2167
110011187,265,357,47,602,826,1475,31,96,127,479
110011188,442,577,76,933,1300,2309,89,203,292,564
110011189,207,219,46,446,609,1101,27,29,56,427
110021190,518,497,131,1258,1798,3187,71,95,166,1246
110021191,577,698,138,1859,2413,4410,94,64,158,1130
110021192,267,224,55,759,1015,1829,31,27,58,719
110021193,311,337,54,822,1095,1971,49,36,85,744
110021194,374,392,117,974,1356,2447,56,61,117,917
110031195,392,509,89,1093,1401,2583,63,80,143,1201
110031196,300,350,49,594,801,1444,48,26,74,733
110031197,334,457,79,1082,1389,2550,69,90,159,841
110031198,216,304,42,564,756,1362,28,25,53,658
110041199,458,554,115,1418,1924,3457,74,102,176,918
110041200,244,255,54,628,782,1464,29,17,46,502
110041201,395,385,115,1084,1474,2673,41,47,88,956
110041202,1339,1356,252,3337,4396,7985,202,240,442,1945
110041203,989,1579,194,2199,2961,5354,246,355,601,1528
110041204,187,169,78,748,1022,1848,13,15,28,632
110041205,1194,1284,231,3133,4039,7403,171,211,382,1947
111011206,1256,1541,195,3304,4317,7816,190,275,465,1326
111011207,377,353,72,1088,1416,2576,53,46,99,429
111011208,1813,2895,248,3955,5183,9386,344,676,1020,1497
111011209,1634,2386,254,4085,5275,9614,331,627,958,1448
111011210,488,448,122,1353,1804,3279,74,85,159,822
111011211,266,434,25,553,724,1302,66,115,181,255
111011212,815,948,120,2157,2810,5087,173,211,384,903
111011213,1108,1728,106,1858,2577,4541,230,477,707,611
111011214,1106,1468,151,2247,2943,5341,195,342,537,921
111021215,555,546,98,1558,2022,3678,90,116,206,784
111021216,746,701,89,1623,2149,3861,103,189,292,616
111021217,901,965,129,2658,3245,6032,106,226,332,886
111021218,1101,1199,166,2574,3495,6235,166,381,547,1516
111021219,969,1203,134,2259,3052,5445,145,344,489,1164
111021220,816,800,98,1812,2390,4300,127,202,329,536
111021221,363,284,87,1440,1780,3307,37,61,98,346
111031222,1317,2311,144,2285,3060,5489,294,614,908,746
111031223,373,279,110,1403,1837,3350,35,56,91,646
111031224,853,1979,97,1498,1991,3586,264,585,849,982
111031225,1312,2442,154,2257,2987,5398,330,762,1092,929
111031226,913,1183,141,2361,2941,5443,135,360,495,566
111031227,1096,1820,189,2339,2981,5509,187,522,709,1220
111031228,1160,2783,106,1596,2164,3866,320,829,1149,869
111031229,819,2580,79,1110,1525,2714,268,992,1260,1063
111031230,0,0,0,0,0,0,0,0,0,0
111031231,593,1060,132,1401,1815,3348,84,439,523,882
111031232,506,621,69,1311,1743,3123,78,179,257,1070
111031233,1361,1949,221,3144,4111,7476,195,577,772,1588
111031234,830,1469,145,1861,2389,4395,186,389,575,1179
111031235,627,1428,66,1134,1474,2674,192,421,613,607
112011236,1271,1566,214,2678,3664,6556,236,298,534,2093
112011237,1377,1916,146,2646,3561,6353,314,441,755,1482
112011238,544,884,39,652,866,1557,103,242,345,692
112011239,768,1023,77,1233,1669,2979,169,243,412,907
112011240,781,1554,65,1146,1608,2819,182,363,545,1559
112011241,307,339,45,934,1181,2160,35,58,93,608
112011242,665,1241,50,1056,1448,2554,181,318,499,553
112011243,697,1042,46,1027,1397,2470,136,261,397,1087
112021244,511,487,181,1879,2483,4543,56,63,119,1226
112021245,380,330,104,1144,1514,2762,53,48,101,783
112021246,810,1250,196,2121,2903,5220,160,224,384,1207
112021247,465,518,81,1087,1486,2654,78,87,165,825
112021248,886,1484,249,2347,3155,5751,261,342,603,1567
112021249,1203,1801,170,2327,3100,5597,324,435,759,1516
112031250,1080,1452,105,1939,2502,4546,206,334,540,1351
112031251,574,625,115,1387,1919,3421,116,107,223,970
112031252,760,919,85,1543,2015,3643,148,201,349,1192
112031253,962,1220,122,2228,2858,5208,183,249,432,1163
112031254,1393,1437,223,3228,4288,7739,195,339,534,2401
112031550,1174,1098,141,2654,3474,6269,170,187,357,1335
112031551,257,346,36,541,712,1289,50,67,117,155
112031552,514,421,85,1334,1805,3224,47,60,107,940
113011256,932,1263,175,2637,3394,6206,161,240,401,2290
113011257,592,766,131,1782,2351,4264,86,90,176,1444
113011258,452,634,115,1456,1949,3520,75,84,159,1170
113011259,280,307,90,806,1075,1971,39,30,69,841
113021260,193,188,39,530,661,1230,37,23,60,531
113021261,327,399,67,942,1230,2239,32,44,76,820
113021262,291,320,63,763,993,1819,39,40,79,497
113031263,478,442,95,1168,1616,2879,62,68,130,805
113031264,170,210,49,533,650,1232,14,22,36,396
113031265,275,310,75,836,1140,2051,31,43,74,1455
113031266,309,409,83,1015,1356,2454,61,44,105,652
113031267,1123,1678,187,2759,3619,6565,247,440,687,1082
113031268,266,526,33,658,829,1520,53,144,197,338
113031269,1280,1881,252,3523,4514,8289,258,371,629,1446
113031270,668,1281,173,1798,2444,4415,142,361,503,1217
113031271,858,1086,178,2487,3206,5871,140,196,336,1509
114011272,788,1051,82,1355,1880,3317,173,332,505,994
114011273,268,271,28,697,936,1661,41,63,104,379
114011274,322,294,72,964,1210,2246,67,66,133,564
114011275,0,3,0,7,15,22,0,0,0,0
114011276,374,499,49,705,922,1676,98,204,302,399
114011277,1260,1306,206,2733,3669,6608,242,290,532,1486
114011278,1212,1002,260,3370,4318,7948,166,217,383,2918
114011279,898,582,179,2642,3490,6311,122,122,244,1402
114011280,239,198,48,943,1218,2209,29,41,70,459
114011281,271,275,56,748,974,1778,44,62,106,289
114011282,1036,1075,205,2681,3641,6527,201,252,453,1633
114011283,363,399,66,1038,1417,2521,78,118,196,526
114021284,1326,1882,120,1451,2241,3812,312,665,977,1176
114021285,401,347,67,1194,1492,2753,55,70,125,383
114021286,694,930,86,1348,1892,3326,131,321,452,959
114021287,696,903,99,1546,2131,3776,142,269,411,858
114021288,318,443,53,544,778,1375,64,145,209,339
114021289,596,884,72,988,1442,2502,132,253,385,622
115011290,1916,4007,133,2180,3198,5511,422,1802,2224,1272
115011291,1891,3830,134,1832,2738,4704,343,1568,1911,832
115011294,656,1093,43,647,988,1678,134,286,420,359
115011296,1036,2927,76,845,1452,2373,257,1186,1443,521
115011553,674,1506,73,637,981,1691,129,608,737,376
115011554,447,1048,24,349,598,971,101,387,488,776
115011555,1102,2201,67,1023,1622,2712,232,870,1102,579
115011556,851,1931,57,751,1224,2032,202,725,927,446
115011557,455,1029,25,357,595,977,69,453,522,219
115011558,1660,4148,85,1141,1889,3115,462,1810,2272,909
115011559,2010,3880,162,2164,3245,5571,341,1465,1806,1017
115021297,1805,2894,145,2834,3911,6890,308,849,1157,1481
115021298,484,725,51,746,1055,1852,87,222,309,354
115031299,202,222,31,473,641,1145,35,77,112,386
115031300,1833,1858,234,4214,5293,9741,289,487,776,1616
115041301,793,767,97,2063,2575,4735,109,176,285,673
115041302,1912,3537,158,2400,3273,5831,309,1164,1473,999
116011303,1326,2313,143,1717,2330,4190,160,1092,1252,1261
116011304,1258,1926,155,2113,2907,5175,127,664,791,1151
116011306,1512,3355,189,2085,2883,5157,190,1011,1201,1421
116011307,1874,2802,248,3162,4404,7814,318,959,1277,1877
116011308,1763,2993,163,2602,3474,6239,236,1250,1486,1700
116011560,861,1389,106,1300,1804,3210,102,490,592,846
116011561,1147,1829,132,1812,2455,4399,131,637,768,1099
116021309,1252,2803,107,1351,1926,3384,196,1171,1367,633
116021310,2561,5543,189,2768,3783,6740,450,2241,2691,2391
116021312,1117,2029,144,2212,2970,5326,173,703,876,1343
116021562,296,644,30,421,565,1016,46,225,271,129
116021563,1822,3336,233,2541,3535,6309,319,1254,1573,1011
116031313,729,683,221,1791,2626,4638,61,142,203,1821
116031314,588,883,76,1003,1284,2363,55,261,316,491
116031315,1398,2356,229,2312,3188,5729,119,491,610,1194
116031316,917,1141,220,2006,2810,5036,74,442,516,2075
116031317,1312,2063,223,2113,3050,5386,120,675,795,1727
116031318,0,0,0,6,6,12,0,0,0,11
116031319,1409,2635,182,2446,3412,6040,139,589,728,1277
117011320,0,0,0,3,3,6,0,0,0,0
117011321,898,1373,84,1281,1708,3073,124,505,629,954
117011322,1822,4277,155,2076,2919,5150,277,1727,2004,1902
117011323,802,1459,84,1143,1611,2838,114,594,708,1135
117011324,0,0,0,0,0,0,0,0,0,0
117011325,0,3,0,3,3,6,0,0,0,32
117021326,1855,5380,156,1948,2811,4915,575,2117,2692,2406
117021327,1570,5007,108,1416,2061,3585,602,2105,2707,1938
117021328,628,1568,55,716,991,1762,182,549,731,593
117031329,894,3499,50,548,861,1459,284,1442,1726,1975
117031330,1341,4811,93,1084,1536,2713,526,2029,2555,1485
117031331,1384,5339,97,1002,1488,2587,501,2650,3151,2223
117031332,1571,7168,124,1302,1869,3295,691,2891,3582,2417
117031333,1636,5506,118,1290,1972,3380,522,2442,2964,4964
117031334,1719,6197,95,937,1501,2533,376,2473,2849,2606
117031335,1635,6282,89,1133,1786,3008,451,2462,2913,3038
117031336,1373,4918,66,861,1377,2304,388,1959,2347,2444
117031337,2865,7279,101,928,1545,2574,308,2850,3158,4677
117031338,2472,7750,156,2174,3087,5417,575,3486,4061,3924
118011339,1478,4850,79,1145,1793,3017,381,1809,2190,2140
118011340,1542,5708,72,1172,1828,3072,450,1883,2333,2712
118011341,1260,4197,49,909,1437,2395,341,1624,1965,2303
118011342,0,0,0,0,0,0,0,0,0,0
118011343,1834,6903,107,953,1804,2864,568,2673,3241,2845
118011344,924,2672,44,637,1027,1708,197,873,1070,871
118011345,1049,4595,42,671,1158,1871,411,2008,2419,1613
118011346,847,2914,36,434,861,1331,201,1007,1208,998
118011347,514,2311,12,276,509,797,187,898,1085,893
118021348,1936,6253,109,1793,2665,4567,674,2535,3209,2479
118021350,1687,2832,160,2514,3481,6155,280,1181,1461,3879
118021564,889,3216,74,690,1081,1845,201,1545,1746,1296
118021565,887,3737,91,823,1283,2197,219,1645,1864,1094
118021566,724,2079,54,767,1149,1970,162,834,996,752
118021567,826,1931,55,982,1361,2398,190,815,1005,1022
118021568,707,2051,46,704,1085,1835,148,911,1059,792
118021569,1325,4259,83,1255,1882,3220,430,1779,2209,1444
118021570,914,3236,61,870,1207,2138,300,1393,1693,1567
119011354,1360,1607,166,2234,3199,5599,119,411,530,1743
119011355,82,162,0,52,79,131,9,67,76,78
119011356,712,1021,89,1088,1512,2689,66,243,309,767
119011357,1521,2198,168,2198,3108,5474,157,663,820,2047
119011358,1259,2030,133,1964,2789,4886,191,608,799,1163
119011359,2030,2860,206,3611,4880,8697,274,829,1103,1588
119011360,1196,1939,132,1870,2556,4558,152,546,698,1135
119011361,1262,1868,186,1893,2636,4715,124,457,581,1534
119011571,1114,1991,109,1110,1667,2886,126,748,874,1355
119011572,1039,1625,107,1093,1640,2840,70,434,504,1521
119021362,1374,2140,147,1741,2486,4374,161,648,809,1418
119021363,2324,4343,192,2068,3091,5351,271,1671,1942,2288
119021364,1828,3140,162,2290,3399,5851,290,1015,1305,1750
119021366,1271,1789,134,1626,2332,4092,95,599,694,1627
119021367,972,1526,105,1343,2000,3448,97,431,528,980
119021573,889,2108,109,869,1344,2322,135,1120,1255,1319
119021574,674,1319,61,562,870,1493,92,645,737,833
119031368,1715,4274,87,1289,1928,3304,230,2206,2436,1658
119031369,1918,4129,160,2293,3373,5826,356,1642,1998,1550
119031370,1024,1983,93,1133,1720,2946,139,649,788,994
119031371,1037,2424,95,1186,1848,3129,239,896,1135,673
119031372,1516,2326,136,2153,3184,5473,264,690,954,1161
119031373,772,1420,108,832,1324,2264,88,539,627,993
119031374,2014,4450,159,1711,2714,4584,286,1808,2094,1420
119041375,1699,4283,101,1543,2223,3867,306,1838,2144,1796
119041376,2039,3882,162,2201,3266,5629,274,1436,1710,2292
119041377,1036,1833,104,1143,1737,2984,148,533,681,776
119041378,894,2315,50,817,1199,2066,140,1036,1176,844
119041379,1409,2745,90,1367,2043,3500,192,1046,1238,1008
119041380,1197,1911,122,1405,2082,3609,139,593,732,1430
119041381,1570,3649,107,1439,2102,3648,219,1493,1712,2010
119041382,1440,2031,143,1867,2830,4840,183,590,773,1372
120011383,1851,3985,128,1990,3086,5204,400,1485,1885,1399
120011384,1826,6018,108,1307,1964,3379,388,3300,3688,1749
120011385,1517,3823,111,1439,2268,3818,460,1463,1923,1561
120011386,1743,3747,127,1791,2786,4704,443,1403,1846,1692
120021387,1172,4051,64,751,1227,2042,510,2028,2538,1429
120021388,1965,6239,140,1660,2491,4291,776,2756,3532,2093
120021389,1073,3269,50,906,1348,2304,379,1476,1855,1145
120031390,1937,5459,118,1519,2291,3928,493,2458,2951,2192
120031391,1830,5206,114,1277,1991,3382,368,2396,2764,1780
120031392,843,1836,51,931,1351,2333,228,744,972,701
120031393,1305,2810,125,1600,2332,4057,263,996,1259,1178
120031394,1321,3484,120,1359,1915,3394,551,1461,2012,1457
120031395,998,2884,67,955,1430,2452,332,1271,1603,953
120031396,1176,3497,82,793,1217,2092,210,1804,2014,1662
120031575,1747,6110,102,1123,1836,3061,333,2498,2831,2005
120031576,270,614,40,305,425,770,57,216,273,238
121011398,2046,7187,107,1083,1843,3033,573,3376,3949,2006
121011399,1726,5364,75,1114,1858,3047,505,2524,3029,1285
121011400,1942,6886,120,1232,2148,3500,741,3197,3938,1552
121011401,799,3085,38,493,772,1303,291,1498,1789,802
121011402,1887,6091,125,1121,2099,3345,615,2474,3089,1400
121021403,1705,3071,176,2141,3199,5516,389,1098,1487,852
121021404,1071,1813,100,1535,2214,3849,249,618,867,569
121021406,1506,3750,137,1267,2196,3600,484,1628,2112,998
121021577,973,2706,62,722,1119,1903,233,1338,1571,638
121021578,949,2040,55,899,1329,2283,245,929,1174,728
121021579,720,2283,43,494,822,1359,226,1137,1363,670
121031407,1417,5508,83,646,1381,2110,458,2668,3126,1323
121031408,1666,5951,66,786,1542,2394,596,2775,3371,1189
121031409,1180,4038,57,585,1096,1738,458,1961,2419,729
121031410,1768,4728,88,899,1749,2736,464,2158,2622,1112
121031411,1606,4471,69,889,1830,2788,508,1940,2448,1303
121031412,1431,4258,98,801,1540,2439,453,1837,2290,1187
121041413,1715,5439,95,893,1650,2638,582,2224,2806,1506
121041414,1544,5539,96,842,1419,2357,589,2507,3096,1439
121041415,2318,7419,121,1081,2064,3266,713,3318,4031,2384
121041416,1534,5483,53,818,1480,2351,518,2312,2830,1830
121041417,834,3343,31,401,701,1133,318,1662,1980,1204
122011418,1698,4635,89,1179,2076,3344,496,1573,2069,1206
122011419,1875,5931,111,1299,2093,3503,539,2292,2831,2157
122021420,1343,2217,77,1301,1993,3371,269,662,931,835
122021421,1069,1727,72,1159,1809,3040,193,576,769,965
122021422,1438,2389,99,1532,2311,3942,272,691,963,718
122021423,2335,3494,174,3119,4436,7729,388,979,1367,1964
122031424,1192,1886,118,1704,2466,4288,186,531,717,942
122031425,762,961,68,1018,1477,2563,95,251,346,487
122031426,2432,4431,247,2846,4128,7221,426,1263,1689,1974
122031427,1064,2351,68,992,1540,2600,266,887,1153,645
122031428,2465,4218,182,2379,3855,6416,457,1337,1794,1456
122031429,1932,4379,135,2077,2970,5182,428,1411,1839,1526
122031430,1492,3009,98,1685,2469,4252,364,938,1302,1124
122031431,2367,3911,203,3159,4576,7938,451,1011,1462,2290
122031432,320,556,9,443,617,1069,64,174,238,261
123011433,1057,1310,89,2166,2816,5071,203,340,543,1037
123011434,1715,1887,222,3238,4165,7625,258,483,741,1112
123011435,2277,2373,289,4605,5882,10776,279,605,884,1214
123021436,1147,1029,209,2822,3721,6752,107,255,362,1413
123021437,1293,1755,199,2338,3165,5702,150,504,654,1582
123021438,1371,1276,228,3016,4043,7287,135,320,455,1434
123021439,0,0,0,0,0,0,0,0,0,0
123021440,1382,2363,180,2398,3259,5837,177,885,1062,1552
123021441,1164,1222,180,2613,3476,6269,135,401,536,1120
123021442,1487,2419,233,2449,3439,6121,165,1231,1396,2071
123021443,1310,1722,191,2366,3292,5849,147,717,864,1271
123021444,1391,1429,231,2938,4028,7197,177,357,534,1693
123031445,389,282,57,1133,1463,2653,52,65,117,401
123031446,800,808,93,1842,2283,4218,126,198,324,613
123031447,1159,1094,187,3064,3940,7191,171,318,489,1481
123031448,622,638,110,1757,2236,4103,96,199,295,649
124011449,519,844,66,714,1023,1803,140,321,461,466
124011450,1758,2924,179,2617,3613,6409,521,1058,1579,985
124011451,0,0,0,3,3,6,0,0,0,0
124011452,1309,1909,145,1608,2310,4063,342,778,1120,1463
124011453,1070,1508,77,1753,2284,4114,298,548,846,630
124011454,2127,2865,192,3162,4376,7730,546,1056,1602,1165
124011455,573,944,34,753,1132,1919,178,375,553,503
124021456,0,0,0,0,0,0,0,0,0,0
124031457,954,852,193,2778,3620,6591,86,212,298,985
124031458,1673,1900,217,3831,4757,8805,205,581,786,1413
124031459,1110,1219,127,2304,2994,5425,199,403,602,1021
124031460,1748,1968,171,3145,3989,7305,230,551,781,977
124031461,1146,1235,169,2866,3728,6763,164,336,500,1195
124031462,1239,1709,209,2749,3564,6522,186,620,806,1487
124031463,692,895,69,1504,1941,3514,93,245,338,706
124031464,912,1113,150,1867,2586,4603,113,395,508,1422
124031465,310,309,50,1027,1312,2389,10,64,74,329
124041466,1034,1027,146,2249,2995,5390,145,308,453,1180
124041467,978,902,185,2806,3596,6587,123,228,351,1021
124041468,339,316,57,1251,1530,2838,38,86,124,1503
124051469,449,535,63,1112,1430,2605,36,121,157,334
124051470,1303,1445,200,3180,4176,7556,120,348,468,1261
124051580,610,595,122,1640,2166,3928,60,171,231,925
124051581,850,931,198,2070,2734,5002,68,261,329,1834
125011473,1352,3866,89,1023,1555,2667,298,1801,2099,3472
125011475,0,0,0,0,0,0,0,0,0,0
125011582,1042,1894,90,879,1334,2303,91,802,893,1295
125011583,728,1503,62,509,766,1337,83,678,761,1002
125011584,489,852,57,527,740,1324,58,259,317,611
125011585,584,1145,74,633,943,1650,63,272,335,563
125011586,1553,3380,95,1200,1765,3060,202,1050,1252,1564
125011587,350,537,38,397,595,1030,26,163,189,346
125021476,2224,5434,161,1838,3001,5000,500,2494,2994,1479
125021477,1686,3028,138,2201,3068,5407,243,1117,1360,1389
125021478,1434,3049,122,1543,2228,3893,243,1241,1484,1209
125031479,1097,1464,141,1702,2366,4209,105,346,451,1799
125031480,815,1036,115,1249,1796,3160,41,224,265,1608
125031481,1468,2482,143,1514,2156,3813,162,916,1078,1731
125031482,1913,3045,222,3143,4324,7689,236,864,1100,1654
125031483,1236,1563,171,1607,2368,4146,98,477,575,1922
125031484,1365,1786,178,2054,2912,5144,125,533,658,1654
125031485,2034,3214,217,2550,3654,6421,223,1116,1339,2021
125031486,0,0,0,3,3,6,0,0,0,0
125031487,0,0,0,0,0,0,0,0,0,0
125041489,1711,4183,138,1565,2299,4002,358,2025,2383,2280
125041490,711,1430,41,749,1147,1937,155,573,728,377
125041491,1351,4286,82,1439,2135,3656,329,2491,2820,1745
125041492,1956,6875,117,1236,1797,3150,443,3992,4435,2911
125041493,1608,3182,154,2279,3305,5738,289,1359,1648,1408
125041494,960,1661,93,1241,1798,3132,189,498,687,467
125041588,846,1880,58,869,1225,2152,137,1161,1298,948
125041589,992,2993,84,890,1314,2288,209,1750,1959,1134
126011495,2018,6500,125,1322,2226,3673,628,3477,4105,1308
126011496,1634,4641,95,1200,1990,3285,547,2275,2822,1143
126021497,1921,5433,117,1426,2281,3824,468,2767,3235,1315
126021498,1274,2925,85,1181,1806,3072,282,1089,1371,1009
126021499,733,2100,51,543,947,1541,222,928,1150,964
126021500,1598,5304,110,1116,1844,3070,368,2813,3181,1672
126021501,946,2368,85,1053,1579,2717,205,988,1193,678
126021503,1575,4573,104,1461,2169,3734,352,2157,2509,1070
126021590,361,801,19,383,639,1041,54,275,329,229
126021591,2220,5161,202,2278,3396,5876,407,2318,2725,2025
127011504,750,555,207,1440,2128,3775,29,113,142,1964
127011505,437,501,79,1298,1678,3055,30,82,112,957
127011506,1329,1600,178,2671,3495,6344,143,474,617,1463
127011592,0,0,0,0,3,3,0,0,0,10
127011593,516,797,58,773,1082,1913,53,137,190,379
127011594,804,990,133,1216,1764,3113,50,145,195,723
127011595,922,1095,87,1410,1925,3422,75,222,297,644
127011596,892,1131,99,1283,1725,3107,61,262,323,610
127011597,1159,1637,126,1667,2262,4055,96,353,449,838
127021509,990,1225,159,1393,2024,3576,74,186,260,852
127021510,1329,1726,171,2137,3019,5327,98,308,406,1097
127021511,1209,1684,195,1512,2317,4024,79,269,348,1825
127021512,900,1089,138,1615,2245,3998,52,170,222,1209
127021513,1002,1521,177,1496,2140,3813,64,229,293,1259
127021514,701,909,87,976,1421,2484,35,139,174,465
127021515,1070,1338,140,1272,1873,3285,70,307,377,1244
127021516,1087,1225,158,1605,2275,4038,86,242,328,1243
127021517,566,708,58,793,1095,1946,34,111,145,445
127021518,238,314,30,677,885,1592,13,70,83,498
127021519,1135,1254,171,2044,2773,4988,91,246,337,1359
127021520,645,977,88,989,1419,2496,51,158,209,625
127021521,0,0,0,6,6,12,0,0,0,0
127031522,1173,1593,123,1697,2359,4179,124,419,543,1271
127031523,1429,2081,151,2501,3328,5980,164,603,767,1063
127031524,1702,2679,183,2739,3635,6557,243,894,1137,1085
127031598,1873,2354,224,2334,3263,5821,143,762,905,3562
127031599,634,586,115,1089,1576,2780,36,136,172,1198
127031600,1381,1933,142,1801,2453,4396,113,558,671,1058
127031601,376,564,55,502,713,1270,28,196,224,903
128011529,1669,2477,168,2551,3539,6258,287,747,1034,914
128011530,1602,2294,167,2503,3566,6236,220,704,924,1420
128011531,1372,2038,119,1987,2883,4989,184,551,735,1373
128011602,1137,1412,100,1732,2409,4241,168,362,530,869
128011603,1152,1680,94,1626,2357,4077,236,431,667,727
128011604,2421,3387,213,3710,5046,8969,452,1025,1477,2099
128011605,329,539,28,394,567,989,47,176,223,120
128011606,822,1190,61,1004,1403,2468,122,292,414,488
128021533,565,632,49,1170,1644,2863,84,192,276,403
128021534,964,1624,71,1451,2089,3611,161,454,615,441
128021535,1984,2740,190,3054,4360,7604,332,756,1088,1039
128021536,2071,3213,153,2610,3803,6566,444,1062,1506,1100
128021537,3,5,0,0,0,0,0,0,0,3
128021538,1948,2998,151,3040,4105,7296,345,984,1329,1617
128021607,1517,1750,125,2990,3930,7045,240,444,684,824
128021608,658,903,62,1156,1617,2835,141,263,404,297
128021609,399,478,25,595,816,1436,90,118,208,132
197979799,30,31,3,58,73,134,0,7,7,61
199999499,661,1239,131,1419,1918,3468,119,367,486,3584
201011001,855,1366,113,1596,1986,3695,285,371,656,659
201011002,998,1959,85,1217,1621,2923,425,634,1059,964
201011003,1652,2711,219,3350,4164,7733,626,671,1297,1883
201011004,1601,2026,304,3816,4723,8843,395,503,898,2283
201011005,583,966,50,901,1117,2068,212,297,509,514
201011006,436,490,57,1230,1434,2721,86,81,167,492
201011007,259,304,36,687,842,1565,78,46,124,297
201011008,787,905,180,2255,2831,5266,182,155,337,1402
201021009,428,492,41,975,1206,2222,108,105,213,584
201021010,564,571,90,1225,1570,2885,180,164,344,914
201021011,827,1165,61,1143,1508,2712,268,391,659,1011
201021012,440,457,34,955,1139,2128,113,134,247,541
201031013,246,206,37,495,659,1191,35,20,55,401
201031014,281,259,38,609,763,1410,52,39,91,810
201031015,304,285,55,834,1040,1929,85,77,162,380
201031016,383,350,84,1299,1633,3016,67,54,121,903
201031017,278,253,57,939,1182,2178,41,44,85,547
202011018,851,1505,182,2083,2718,4983,309,408,717,1658
202011019,626,605,169,1993,2514,4676,141,93,234,1267
202011020,1042,1636,139,1748,2315,4202,353,403,756,1156
202011021,693,1187,77,1278,1535,2890,277,313,590,709
202011022,1234,1421,215,3219,4025,7459,313,269,582,1941
202011023,339,435,31,938,1107,2076,113,80,193,331
202011024,668,1101,62,1197,1453,2712,238,214,452,481
202011025,709,979,104,2034,2537,4675,191,143,334,937
202021026,538,684,75,1234,1492,2801,174,168,342,560
202021027,757,1270,80,1176,1522,2778,344,478,822,1845
202021028,707,951,61,1294,1629,2984,290,288,578,876
202021029,291,255,47,798,971,1816,64,36,100,559
202021030,730,1035,96,1379,1815,3290,229,282,511,957
202021031,553,1021,49,806,1021,1876,250,331,581,650
202031032,265,273,49,780,966,1795,58,58,116,384
202031033,416,379,68,1048,1299,2415,87,34,121,991
203011034,480,525,48,1165,1414,2627,92,88,180,412
203011035,520,571,70,1242,1526,2838,153,132,285,470
203011036,488,590,47,949,1158,2154,87,138,225,491
203021037,1128,1815,130,2039,2498,4667,335,507,842,1086
203021038,1188,930,340,3683,4711,8734,125,188,313,2869
203021039,1072,2015,93,1699,2128,3920,369,516,885,1137
203021040,1603,2723,146,2777,3420,6343,499,666,1165,1507
203021041,1995,2578,209,3744,4604,8557,383,517,900,1731
203021042,1966,3536,133,2618,3364,6115,574,1081,1655,1362
203021043,1374,1368,141,2964,3595,6700,227,272,499,2064
203021044,1105,1019,104,2407,2928,5439,153,187,340,908
203021045,924,809,157,2593,3160,5910,131,138,269,1413
203021046,861,1884,65,1019,1326,2410,333,536,869,715
203021047,1013,1217,148,2170,2764,5082,199,254,453,1515
203031048,1120,1143,129,2377,3003,5509,245,221,466,1157
203031049,484,871,44,673,896,1613,144,216,360,493
203031050,2154,3300,142,3356,4131,7629,735,839,1574,1488
203031051,603,614,69,1213,1569,2851,119,132,251,948
203031052,459,757,26,384,557,967,143,214,357,440
203031053,1710,2971,118,2310,2888,5316,513,728,1241,1174
204011054,491,484,61,1106,1415,2582,116,97,213,727
204011055,497,485,42,947,1210,2199,107,91,198,722
204011056,967,794,144,2423,3035,5602,192,167,359,1261
204011057,654,758,88,1552,1968,3608,154,163,317,971
204011058,292,279,32,675,833,1540,36,44,80,490
204011059,378,306,78,952,1234,2264,60,47,107,923
204011060,341,332,43,708,909,1660,60,90,150,468
204011061,12,7,0,30,35,65,3,0,3,18
204011062,276,300,31,584,695,1310,56,55,111,441
204021063,758,634,117,1629,2077,3823,158,113,271,1128
204021064,301,303,43,625,807,1475,65,59,124,424
204021065,237,292,34,655,788,1477,49,56,105,378
204021066,1278,1455,192,2914,3673,6779,309,271,580,1901
204021067,848,861,84,1572,1970,3626,205,148,353,931
204031068,457,575,37,610,760,1407,151,173,324,651
204031069,692,869,93,1299,1638,3030,211,177,388,968
204031070,243,237,46,548,693,1287,54,41,95,315
204031071,314,308,42,756,968,1766,69,52,121,492
204031072,444,412,77,1093,1401,2571,82,69,151,611
204031073,1120,1054,175,2612,3258,6045,227,186,413,1061
204031074,1923,1822,329,4149,5274,9752,378,417,795,2125
204031075,349,453,52,789,988,1829,138,122,260,295
205011076,1083,1028,162,2902,3622,6686,226,168,394,1448
205011077,465,496,62,1084,1328,2474,116,89,205,559
205011078,544,557,66,1383,1675,3124,127,108,235,744
205011079,1420,1679,177,3045,3766,6988,391,420,811,1555
205021080,0,0,0,0,0,0,0,0,0,0
205021081,984,953,150,2305,2969,5424,167,158,325,1916
205021082,556,503,103,1373,1656,3132,139,71,210,797
205021083,0,0,0,0,0,0,0,0,0,0
205021084,706,624,121,1799,2298,4218,148,124,272,1246
205021085,416,435,58,934,1262,2254,99,83,182,806
205021086,510,497,52,1199,1492,2743,127,94,221,690
205031087,621,710,80,1440,1812,3332,151,167,318,1075
205031088,0,14,0,9,6,15,0,6,6,6
205031089,585,582,113,1638,2029,3780,121,106,227,829
205031090,748,865,106,1810,2231,4147,187,146,333,1025
205031091,886,904,105,1738,2262,4105,217,186,403,1088
205031092,0,0,0,0,0,0,0,0,0,0
205031093,1549,1616,213,3622,4614,8449,364,358,722,2460
205041094,774,891,157,2118,2540,4815,176,237,413,1139
205041095,935,763,197,3128,3868,7193,135,123,258,1810
205041096,687,593,190,2256,2836,5282,113,98,211,1734
205041097,1731,2141,236,4676,5645,10557,393,424,817,2655
205041098,290,272,42,941,1149,2132,62,39,101,388
205051099,0,0,0,3,3,6,0,0,0,0
205051100,296,284,32,801,989,1822,57,32,89,571
205051101,838,868,149,2513,3087,5749,189,139,328,1355
205051102,254,235,38,734,895,1667,29,27,56,1187
205051103,1025,1229,150,2303,2825,5278,261,252,513,1415
205051104,307,298,66,947,1199,2212,77,32,109,606
206011105,1716,6698,111,1612,2214,3937,1053,2978,4031,1864
206011106,761,3019,66,703,949,1718,486,1303,1789,808
206011107,993,3047,72,1053,1387,2512,549,1255,1804,1054
206011108,1848,4982,135,2112,2763,5010,896,1914,2810,1660
206011109,712,1596,37,914,1224,2175,270,490,760,632
206021110,609,1997,35,599,805,1439,424,865,1289,564
206021111,1587,5901,81,1504,2017,3602,1151,2585,3736,1769
206021112,1332,3941,97,1381,1861,3339,754,1458,2212,1454
206031113,1104,3046,97,1132,1626,2855,503,1081,1584,1114
206031114,2213,5467,148,2412,3229,5789,847,1788,2635,2047
206031115,588,2167,52,547,835,1434,314,942,1256,1110
206031116,1120,3025,56,1121,1473,2650,505,1027,1532,959
206041117,968,4976,69,599,959,1627,369,1928,2297,2091
206041118,860,3270,41,473,745,1259,244,1259,1503,1556
206041119,407,1581,13,159,274,446,212,708,920,652
206041120,0,20,0,0,0,0,0,0,0,37
206041121,748,2900,60,645,911,1616,440,1197,1637,846
206041122,2704,10667,119,1088,1736,2943,568,3884,4452,5161
206041123,1247,5637,93,861,1323,2277,560,2408,2968,2788
206041124,310,1746,37,262,379,678,154,966,1120,960
206041125,467,1852,6,228,356,590,228,796,1024,812
206041126,1424,5552,56,877,1303,2236,470,2453,2923,2627
206041127,0,0,0,0,0,0,0,0,0,0
206051128,1144,4099,61,711,1126,1898,503,1746,2249,1485
206051129,1322,4022,89,1177,1610,2876,606,1395,2001,1493
206051130,1369,3720,83,1230,1745,3058,553,1391,1944,1609
206051131,0,0,0,4,4,8,0,0,0,0
206051132,902,3026,47,654,1011,1712,381,1232,1613,1268
206051133,2283,6521,141,2133,2960,5234,834,2539,3373,4069
206051134,1450,4210,82,1306,1745,3133,573,1458,2031,1614
206061135,748,2573,37,367,662,1066,289,910,1199,759
206061136,1640,5708,99,1355,1859,3313,647,1746,2393,2191
206061137,1628,6477,89,1123,1641,2853,621,2410,3031,2444
206061138,1089,3728,45,546,862,1453,351,1330,1681,1271
206071139,664,2459,29,501,671,1201,324,929,1253,839
206071140,515,2524,36,367,549,952,366,1253,1619,602
206071141,599,2149,64,548,761,1373,265,821,1086,1101
206071142,634,2618,52,533,780,1365,332,1214,1546,1436
206071143,744,3445,45,584,836,1465,593,1609,2202,1087
206071144,2265,8630,136,2044,2843,5023,1097,2707,3804,2840
206071145,540,2362,26,490,674,1190,468,1163,1631,729
207011146,550,1719,19,430,653,1102,309,665,974,414
207011147,1308,3746,63,708,1097,1868,468,1473,1941,916
207011148,1479,4527,66,979,1533,2578,597,1594,2191,1108
207011149,1598,5297,84,945,1554,2583,802,2252,3054,1268
207011150,1213,4091,68,796,1233,2097,660,1546,2206,712
207011151,1634,6452,79,1065,1552,2696,864,2898,3762,1782
207011152,1110,4146,69,752,1115,1936,583,1748,2331,997
207011153,1729,6294,93,1120,1705,2918,858,2631,3489,1876
207011154,423,1516,30,328,487,845,238,578,816,376
207011155,1158,4109,50,660,1058,1768,654,1642,2296,944
207021156,818,1893,59,926,1253,2238,213,634,847,801
207021157,1717,3977,78,1482,2184,3744,446,1522,1968,1379
207021159,1253,3231,76,1286,1848,3210,382,1102,1484,1152
207021160,1122,2492,61,1123,1635,2819,334,810,1144,1048
207021424,1212,2838,54,1034,1562,2650,328,1012,1340,745
207021425,1165,2576,49,1043,1497,2589,254,928,1182,858
207031161,1796,4325,117,1584,2222,3923,746,1618,2364,1261
207031162,866,1891,37,850,1190,2077,324,709,1033,732
207031163,1724,4144,101,1186,1708,2995,507,1683,2190,1531
207031164,1446,3485,66,1245,1721,3032,574,1393,1967,916
207031165,1094,2392,68,718,1088,1874,262,962,1224,811
207031166,873,1922,57,784,1077,1918,204,716,920,583
207031167,805,2481,30,490,769,1289,412,1014,1426,475
208011168,1259,2744,67,962,1440,2469,435,797,1232,888
208011169,1789,5465,76,1063,1764,2903,716,1979,2695,1719
208011170,1317,3398,61,947,1439,2447,507,1121,1628,1079
208011171,1017,1943,54,979,1342,2375,334,588,922,670
208011172,1505,3557,94,1131,1666,2891,572,1283,1855,1178
208011173,1501,3530,89,1173,1763,3025,512,1243,1755,1161
208021174,1846,4401,93,1640,2324,4057,661,1605,2266,1343
208021176,1407,4333,76,1226,1660,2962,524,1908,2432,1177
208021177,1498,5301,74,1035,1586,2695,661,1864,2525,1608
208021178,1431,4110,75,1036,1607,2718,537,1330,1867,1292
208021179,846,2815,41,675,1027,1743,460,953,1413,741
208021180,542,1566,37,524,725,1286,197,622,819,425
208021181,710,2101,38,696,985,1719,349,815,1164,482
208021182,1110,3152,44,843,1223,2110,402,1428,1830,801
208021426,1208,2580,76,1262,1724,3062,353,850,1203,927
208021427,1136,2243,67,1269,1681,3017,332,637,969,791
208031183,788,1276,63,928,1283,2274,147,399,546,469
208031184,0,0,0,0,0,0,0,0,0,6
208031185,1010,1317,86,1760,2241,4087,194,320,514,930
208031186,1290,1806,115,2014,2586,4715,324,496,820,1465
208031187,450,547,41,842,1030,1913,68,139,207,296
208031188,2017,3467,125,2389,3198,5712,554,1044,1598,1550
208031189,1180,1911,73,1601,2006,3680,301,504,805,969
208031190,1188,2281,73,1355,1881,3309,394,664,1058,912
208031191,737,1418,55,859,1169,2083,195,408,603,662
208031192,0,0,0,0,0,0,0,0,0,0
208031193,1806,3119,125,2139,2885,5149,587,943,1530,1340
208041194,1542,5365,74,861,1403,2338,703,1992,2695,1437
208041195,1596,5290,72,1107,1754,2933,674,1990,2664,1222
209011196,795,1302,59,1173,1541,2773,165,417,582,674
209011197,1774,3008,132,2641,3456,6229,596,864,1460,1086
209011198,1099,2986,67,1180,1630,2877,578,1221,1799,1073
209011199,969,1960,84,1357,1761,3202,324,728,1052,1526
209011200,803,2601,62,713,1061,1836,486,1182,1668,693
209011201,581,1894,35,428,669,1132,292,804,1096,370
209011202,1467,2614,104,2095,2698,4897,552,808,1360,856
209011203,1459,3011,107,2002,2590,4699,533,1101,1634,1110
209011204,763,1215,49,1238,1548,2835,198,356,554,511
209021205,801,1926,79,744,1034,1857,215,873,1088,1016
209021207,1985,3516,197,2700,3586,6483,435,1274,1709,2917
209021208,1688,2912,146,2326,3009,5481,462,1107,1569,2031
209021428,1503,3353,135,1696,2248,4079,517,1237,1754,1974
209021429,899,2222,74,1005,1274,2353,396,770,1166,807
209031209,2005,3971,111,2582,3392,6085,823,1308,2131,1097
209031210,283,433,16,581,731,1328,124,116,240,168
209031211,362,256,24,773,906,1703,70,59,129,377
209031212,450,709,42,783,976,1801,148,217,365,480
209031213,818,1285,49,1264,1530,2843,211,323,534,524
209031214,612,1149,40,733,949,1722,216,396,612,387
209031215,1200,1768,86,2146,2620,4852,380,403,783,634
209041216,589,1161,34,615,828,1477,108,457,565,435
209041217,457,784,37,668,850,1555,75,277,352,530
209041219,1414,1778,152,2203,2900,5255,183,555,738,1848
209041220,1407,1983,135,2264,2955,5354,210,489,699,1081
209041221,936,1366,84,1532,2000,3616,125,348,473,809
209041223,1176,1519,158,1918,2629,4705,128,499,627,1633
209041224,1127,947,168,2791,3455,6414,195,209,404,1414
209041225,571,564,66,1504,1835,3405,99,131,230,786
209041430,1831,1939,154,3460,4190,7804,332,400,732,884
209041431,897,1095,119,1624,2083,3826,112,331,443,928
209041432,613,754,89,931,1278,2298,68,220,288,629
209041433,922,1309,71,1037,1351,2459,141,538,679,610
209041434,1361,1658,135,2272,2871,5278,248,589,837,1041
209041435,935,1329,78,1476,1881,3435,164,429,593,609
209041436,850,1200,115,1570,2051,3736,154,340,494,624
209041437,806,1104,73,877,1162,2112,117,511,628,658
210011226,612,876,48,1017,1276,2341,104,223,327,619
210011227,0,0,0,0,0,0,0,0,0,0
210011228,705,975,61,1090,1419,2570,121,192,313,610
210011229,1790,3307,160,2877,3742,6779,398,742,1140,2108
210011230,606,1035,43,797,997,1837,159,283,442,396
210011231,746,1645,55,965,1271,2291,287,402,689,608
210021232,1131,1541,95,1878,2394,4367,336,359,695,854
210021233,283,549,15,381,498,894,126,189,315,272
210021234,363,455,24,688,889,1601,93,93,186,230
210021235,752,776,77,1556,1918,3551,153,153,306,890
210031236,541,1232,47,641,819,1507,234,469,703,688
210031237,747,1413,70,1050,1452,2572,151,614,765,1208
210031239,1894,3716,138,2426,3099,5663,559,1252,1811,1790
210031438,1579,2708,130,2145,2813,5088,333,1069,1402,2076
210031439,249,382,26,337,466,829,39,90,129,192
210031440,373,480,44,617,806,1467,72,135,207,463
210041240,1013,1089,126,2158,2718,5002,209,210,419,834
210041241,2132,2227,242,4621,5733,10596,466,429,895,1840
210051242,765,960,115,1112,1506,2733,81,300,381,1606
210051243,759,777,113,1339,1809,3261,69,232,301,1545
210051245,1311,1448,131,2472,3200,5803,200,267,467,1320
210051246,1269,1832,129,2026,2677,4832,183,382,565,875
210051247,766,827,140,1237,1698,3075,69,150,219,1216
210051248,0,17,0,8,8,16,0,3,3,82
210051249,1321,1677,171,1761,2443,4375,175,469,644,1307
210051250,471,569,54,940,1201,2195,76,109,185,616
210051441,538,488,61,1166,1470,2697,70,183,253,617
210051442,884,1066,79,1192,1533,2804,130,427,557,636
210051443,1211,1400,159,1949,2548,4656,128,516,644,907
210051444,1167,1547,94,1343,1782,3219,145,706,851,766
210051445,298,310,27,515,631,1173,41,102,143,248
211011251,980,1413,80,1729,2223,4032,185,426,611,938
211011254,1245,2181,110,1901,2483,4494,269,640,909,810
211011255,545,834,24,921,1131,2076,107,193,300,389
211011256,1322,2086,98,1955,2496,4549,253,607,860,759
211011257,723,1035,35,1019,1319,2373,137,347,484,328
211011258,920,1459,62,1300,1666,3028,166,406,572,534
211011259,1264,2082,91,1592,2152,3835,271,643,914,876
211011260,1447,2980,116,1824,2468,4408,361,952,1313,1051
211011446,1901,2382,197,3537,4415,8149,375,622,997,1779
211011447,1145,1542,121,2264,2852,5237,253,388,641,951
211011448,1259,1599,136,2409,2982,5527,231,385,616,782
211011449,359,409,34,770,905,1709,83,94,177,239
211021261,1341,2959,76,1435,2004,3515,453,816,1269,976
211021262,903,1596,53,1239,1585,2877,262,432,694,624
211031263,990,1138,94,1945,2382,4421,206,248,454,913
211031265,1653,2515,133,2427,3104,5664,441,605,1046,870
211031266,1460,2499,99,2058,2689,4846,399,862,1261,1024
211031267,1771,3105,127,2403,3133,5663,585,1017,1602,1206
211031268,895,1512,40,1122,1494,2656,257,409,666,500
211031450,1291,1689,127,2237,2821,5185,340,455,795,1155
211031451,1117,1685,107,1727,2304,4138,328,457,785,920
211031452,399,577,33,714,892,1639,95,118,213,265
211041269,920,1896,61,899,1250,2210,260,697,957,605
211041270,1359,3093,72,1479,1943,3494,523,1095,1618,858
211041271,992,2179,55,1064,1412,2531,346,727,1073,814
211041272,952,1794,61,967,1306,2334,256,666,922,495
211041273,1004,2145,61,923,1340,2324,246,813,1059,519
211051274,931,1271,63,1519,1885,3467,273,375,648,660
211051275,892,981,84,1655,2063,3802,161,174,335,569
211051276,1131,1250,144,2292,2854,5290,225,252,477,1139
211051277,748,720,86,1660,2038,3784,131,142,273,735
211051278,1544,1622,158,3367,4120,7645,263,309,572,1164
211051279,459,506,28,994,1168,2190,105,123,228,358
211051280,575,700,43,1173,1433,2649,138,156,294,504
211051281,1834,2109,174,3742,4525,8441,364,453,817,1340
211051282,1001,1583,67,1178,1562,2807,383,531,914,682
211051283,876,790,90,1810,2237,4137,184,152,336,616
211051284,963,1265,63,1573,1946,3582,279,353,632,484
211051285,585,565,64,1483,1798,3345,95,95,190,523
211051286,1187,1021,194,2970,3718,6882,251,186,437,1424
212011287,1248,1247,99,2086,2561,4746,226,323,549,677
212011288,568,577,97,1658,2010,3765,109,86,195,766
212011289,1514,1814,154,3119,3799,7072,350,367,717,1393
212011290,427,301,70,1330,1609,3009,58,25,83,788
212011291,1391,1195,206,3359,4086,7651,192,272,464,1217
212011292,2114,1992,258,4525,5663,10446,302,518,820,1960
212021293,2032,2597,175,3151,4107,7433,430,660,1090,1552
212021294,2210,2900,175,3156,4013,7344,397,1044,1441,1197
212021295,688,642,118,1214,1677,3009,59,176,235,1142
212021297,780,940,93,1286,1728,3107,89,261,350,728
212021299,601,861,38,1132,1379,2549,99,189,288,620
212021453,990,1291,108,1493,1924,3525,135,319,454,882
212021454,1184,1592,74,1558,2012,3644,161,475,636,870
212021455,1075,1156,91,2088,2619,4798,169,304,473,730
212021456,1077,1126,135,2013,2563,4711,117,358,475,920
212031300,1418,1071,209,3085,3921,7215,179,278,457,1795
212031301,2341,2721,217,3295,4134,7646,274,910,1184,1441
212031302,1553,1757,193,2675,3376,6244,185,557,742,1304
212031303,667,580,96,1603,1940,3639,112,87,199,752
212031304,1228,1211,132,2260,2794,5186,132,390,522,875
212031305,1798,1744,243,3257,4165,7665,169,492,661,2063
212031306,1222,1878,81,1480,1953,3514,170,708,878,869
212031308,529,420,59,1501,1826,3386,68,76,144,638
212031457,1092,1233,80,1804,2313,4197,177,285,462,581
212031458,1236,1349,164,2178,2778,5120,155,390,545,944
212041309,851,1467,77,1271,1675,3023,148,453,601,822
212041310,929,1871,79,996,1345,2420,133,829,962,892
212041311,2035,2481,238,2726,3724,6688,186,876,1062,3256
212041312,1684,2004,187,2584,3455,6226,230,506,736,1763
212041313,935,1206,65,1370,1716,3151,185,272,457,664
212041314,1799,3078,153,2354,3131,5638,282,908,1190,1414
212041316,545,721,64,827,1114,2005,79,191,270,525
212041317,1476,2311,150,1504,2087,3741,137,661,798,1886
212041318,763,1072,101,1031,1400,2532,92,259,351,826
212041459,1135,1492,107,1175,1660,2942,120,534,654,1148
212041460,1335,1653,111,1712,2266,4089,142,541,683,1466
212051319,1427,3659,88,1364,1856,3308,420,1363,1783,1482
212051320,1630,4451,77,1071,1467,2615,293,2333,2626,1726
212051321,1751,4345,76,1244,1843,3163,444,1904,2348,1124
212051322,1571,3772,85,1081,1657,2823,437,1689,2126,1251
212051323,1234,3118,62,1046,1466,2574,434,1342,1776,907
212051324,1490,3568,68,1276,1767,3111,465,1539,2004,1181
212051325,1515,3019,79,1979,2579,4637,324,1040,1364,1426
212051326,1617,3688,133,1862,2508,4503,454,1526,1980,1644
212051327,1613,3571,99,1609,2293,4001,426,1383,1809,1299
213011328,546,796,55,847,1095,1997,101,303,404,838
213011329,590,1286,61,765,1100,1926,86,221,307,495
213011330,1703,2810,202,2604,3550,6356,197,694,891,2025
213011331,523,719,82,973,1288,2343,59,115,174,558
213011332,940,1274,116,1669,2162,3947,145,263,408,815
213011333,797,929,116,1376,1873,3365,61,133,194,1187
213011334,1218,1535,163,1982,2616,4761,108,415,523,2122
213011335,1021,1423,113,1402,1922,3437,81,332,413,1659
213011336,627,1246,82,877,1153,2112,150,341,491,933
213011337,650,1039,76,957,1262,2295,74,223,297,996
213011338,1095,1718,111,1636,2226,3973,127,396,523,1576
213011339,928,1378,94,1395,1777,3266,135,392,527,999
213011340,1330,2088,121,2177,2861,5159,211,382,593,1123
213021341,1045,1814,63,1577,2061,3701,313,580,893,995
213021342,1391,2039,138,2436,3155,5729,277,546,823,1379
213021343,853,1465,93,1483,1951,3527,191,389,580,1269
213021344,1332,3366,91,1728,2185,4004,574,1118,1692,1057
213021345,385,591,25,597,765,1387,87,199,286,375
213021346,1188,2907,74,1252,1680,3006,574,1144,1718,1061
213031347,1221,2666,102,1301,1814,3217,233,818,1051,1729
213031348,1246,3375,113,1068,1496,2677,443,1407,1850,1836
213031349,1031,2358,74,1012,1377,2463,286,845,1131,949
213031350,722,2009,32,675,929,1636,397,700,1097,593
213031351,881,2074,70,996,1262,2328,362,800,1162,853
213031352,1063,3155,67,1214,1634,2915,532,968,1500,958
213041353,1466,1508,177,3323,4156,7656,327,360,687,1494
213041355,1529,2231,156,2649,3451,6256,258,491,749,1115
213041356,1209,890,216,3015,3894,7125,160,158,318,1612
213041357,1534,1550,233,3477,4419,8129,224,428,652,1824
213041358,1165,1040,198,2712,3453,6363,140,231,371,1347
213041359,95,79,9,246,299,554,3,14,17,1490
213041360,1366,2211,125,2062,2685,4872,206,564,770,901
213041461,340,482,43,557,763,1363,28,80,108,293
213041462,448,748,36,552,732,1320,63,248,311,291
213041463,1461,2543,124,2099,2804,5027,324,695,1019,1254
213051361,1478,1681,148,2683,3364,6195,194,532,726,1309
213051362,1387,1687,156,2567,3347,6070,236,624,860,1316
213051363,656,1337,68,759,973,1800,124,718,842,731
213051365,2681,4335,220,3244,4248,7712,359,2364,2723,2048
213051366,1795,3363,98,1661,2244,4003,326,1942,2268,2382
213051368,853,1070,89,1503,1942,3534,171,286,457,975
213051369,1790,1973,177,3163,3945,7285,243,899,1142,1397
213051464,1004,1944,74,1036,1416,2526,208,828,1036,694
213051465,1782,3426,126,2059,2748,4933,386,1587,1973,1174
213051466,1126,2544,59,1074,1379,2512,267,1359,1626,697
213051467,1226,1411,199,2607,3391,6197,182,494,676,1816
213051468,939,1030,132,1929,2437,4498,162,259,421,815
214011370,1535,1276,243,3507,4423,8173,190,280,470,1799
214011371,1972,2104,235,3609,4617,8461,388,450,838,2338
214011372,1404,1139,186,3213,4085,7484,201,269,470,2095
214011373,1695,2338,137,2462,3184,5783,432,584,1016,1315
214011374,1942,1809,209,4703,5638,10550,350,246,596,1563
214011375,1417,1522,135,2769,3451,6355,257,327,584,1615
214011376,1173,1209,108,2009,2519,4636,170,271,441,682
214021377,910,1017,83,1817,2346,4246,199,188,387,1039
214021378,487,923,47,607,784,1438,156,278,434,529
214021379,1727,1572,215,4081,5037,9333,343,316,659,1944
214021380,2192,2529,210,3601,4668,8479,493,542,1035,2079
214021381,1725,2921,89,1819,2446,4354,486,833,1319,1121
214021382,1877,2267,141,2542,3272,5955,452,514,966,1276
214021383,1529,1673,177,2730,3493,6400,314,363,677,1891
214021384,1626,1366,213,3594,4594,8401,292,237,529,2345
214021385,1537,1278,155,3463,4222,7840,233,217,450,1396
215011386,507,464,77,1164,1472,2713,107,60,167,1414
215011387,247,266,23,439,536,998,43,31,74,421
215011388,1093,1228,197,2542,3177,5916,231,223,454,1372
215011389,285,254,47,510,682,1239,74,44,118,285
215011390,386,407,93,992,1287,2372,72,68,140,641
215011391,187,200,45,498,653,1196,29,14,43,339
215011392,534,510,92,1242,1581,2915,92,84,176,913
215011393,196,178,31,357,485,873,29,19,48,249
215011394,403,363,65,989,1283,2337,64,34,98,792
215021395,401,463,80,1145,1435,2660,100,59,159,589
215021396,261,234,56,763,994,1813,47,20,67,497
215021398,195,200,36,500,645,1181,32,24,56,424
215021399,301,271,54,901,1099,2054,55,37,92,735
215021469,1042,1272,239,2393,3156,5788,211,188,399,2240
215021470,862,978,156,2003,2527,4686,184,163,347,1477
215031400,313,392,69,898,1099,2066,76,39,115,763
215031401,352,324,60,1077,1302,2439,45,25,70,659
215031402,212,217,36,569,729,1334,40,14,54,490
215031403,135,131,9,261,345,615,22,15,37,569
215031404,650,722,102,1525,1911,3538,116,94,210,1356
215031405,344,307,66,955,1207,2228,55,23,78,978
216011406,902,1041,121,2438,2951,5510,211,131,342,1511
216011407,666,615,133,1762,2218,4113,116,83,199,1178
216011408,200,208,39,676,792,1507,30,25,55,404
216011409,209,191,47,616,761,1424,43,24,67,403
216011410,238,185,26,644,797,1467,40,22,62,489
216021411,342,297,66,890,1139,2095,35,45,80,735
216021412,144,137,36,448,560,1044,39,13,52,303
216021413,775,624,110,1952,2416,4478,153,83,236,1199
216021414,454,468,70,1349,1664,3083,72,68,140,1062
216031415,488,329,102,1199,1540,2841,107,51,158,890
216031416,1192,1684,154,2362,2887,5403,315,439,754,1829
216031417,1338,1419,196,3155,3891,7242,336,251,587,2227
216031418,276,265,28,589,742,1359,69,53,122,317
216031419,638,620,102,1434,1818,3354,127,117,244,1317
217011420,515,463,118,1443,1800,3361,105,69,174,960
217011421,608,786,134,1602,2034,3770,154,138,292,924
217011422,613,638,129,1852,2320,4301,133,94,227,1141
217011423,471,532,68,910,1172,2150,83,83,166,590
217031471,200,211,35,525,642,1202,36,46,82,397
217031472,731,688,115,1951,2447,4513,126,113,239,1171
217031473,361,395,62,867,1069,1998,65,78,143,516
217031474,323,363,39,730,918,1687,59,36,95,638
217031475,419,450,76,1084,1339,2499,80,62,142,682
217031476,293,401,30,558,708,1296,63,95,158,423
217041477,475,424,63,1019,1305,2387,74,53,127,658
217041478,675,894,77,1382,1764,3223,175,194,369,902
217041479,1402,1786,235,3294,4086,7615,365,301,666,1816
217041480,898,1378,108,1799,2260,4167,231,259,490,1442
297979799,0,3,0,12,12,24,0,0,0,3
299999499,417,807,56,772,1040,1868,89,241,330,2107
301011001,1245,1245,180,3098,3813,7091,165,224,389,928
301011002,595,1117,48,928,1122,2098,111,323,434,374
301011003,1236,1438,113,2510,3160,5783,217,333,550,1045
301011004,1298,1490,216,3272,4112,7600,184,297,481,924
301011005,319,346,39,666,809,1514,44,61,105,246
301011006,1099,1342,95,1715,2204,4014,227,322,549,555
301021007,1320,1571,139,2332,3071,5542,197,369,566,1304
301021008,568,746,48,783,1072,1903,119,240,359,337
301021009,1224,1149,170,2862,3561,6593,174,269,443,1036
301021011,669,865,68,1398,1684,3150,125,197,322,314
301021012,1393,1402,131,2431,3067,5629,195,345,540,787
301021013,1231,1130,140,2689,3467,6296,205,236,441,1092
301021527,703,628,114,1634,2099,3847,109,171,280,1033
301031014,0,0,0,0,0,0,0,0,0,0
301031015,652,1015,53,1032,1368,2453,152,351,503,489
301031016,926,1345,92,1641,2128,3861,188,282,470,669
301031017,322,599,25,549,687,1261,73,153,226,283
301031018,696,1006,71,1365,1744,3180,142,208,350,520
301031019,766,1397,37,981,1260,2278,164,419,583,367
301031020,1112,1626,119,1835,2325,4279,267,472,739,923
301031021,1064,1413,132,2251,2899,5282,201,284,485,1106
302011022,523,739,61,1219,1516,2796,85,163,248,340
302011023,703,1431,56,812,1111,1979,171,465,636,383
302011024,761,1393,78,1043,1352,2473,199,456,655,781
302011025,745,1472,74,1199,1515,2788,195,395,590,461
302011026,647,1214,46,841,1187,2074,207,366,573,371
302021027,1033,1863,91,1569,2039,3699,231,456,687,840
302021028,703,1468,92,1110,1435,2637,122,390,512,1098
302021029,520,902,33,820,1024,1877,156,257,413,300
302021030,345,591,28,591,744,1363,83,125,208,253
302021031,1083,2650,114,1493,1937,3544,363,746,1109,914
302021032,492,1133,77,914,1122,2113,148,241,389,391
302021033,523,983,53,837,1127,2017,163,249,412,521
302021034,783,1699,42,1181,1550,2773,234,425,659,513
302031035,801,1037,84,1335,1725,3144,150,283,433,486
302031036,6,4,0,12,12,24,0,0,0,106
302031037,75,159,3,118,131,252,7,30,37,120
302031038,500,1096,55,871,1083,2009,165,262,427,459
302031039,739,1222,85,1300,1668,3053,183,328,511,785
302031040,1112,2395,106,1430,1879,3415,287,720,1007,1012
302041041,1404,1787,151,2663,3301,6115,227,405,632,904
302041042,798,1129,68,1445,1817,3330,164,264,428,669
302041043,260,382,23,600,712,1335,64,63,127,299
302041044,522,966,44,827,1032,1903,192,297,489,681
302041045,1053,1731,121,1443,1914,3478,194,525,719,817
302041046,720,1019,111,1244,1610,2965,86,258,344,727
303011047,781,2298,61,1039,1420,2520,325,678,1003,616
303011048,430,953,20,705,855,1580,126,257,383,495
303011049,959,1855,63,1288,1623,2974,279,460,739,833
303011050,557,1143,62,815,1061,1938,173,335,508,350
303011051,1234,2893,103,1426,1992,3521,418,977,1395,814
303021052,866,2654,87,1010,1389,2486,340,949,1289,946
303021053,1362,3744,101,1488,1962,3551,509,1180,1689,1098
303021054,286,1103,18,390,512,920,166,523,689,316
303021055,774,2150,62,880,1181,2123,270,679,949,704
303021056,586,1568,48,808,1064,1920,268,489,757,505
303021057,498,1307,43,677,844,1564,180,375,555,387
303021058,375,1280,36,502,641,1179,142,433,575,641
303021059,736,2132,52,754,980,1786,303,796,1099,874
303031060,1159,2837,102,1171,1639,2912,268,1287,1555,832
303031061,423,1118,45,449,653,1147,106,513,619,407
303031062,681,1288,55,945,1245,2245,167,393,560,482
303031063,1120,2661,113,1635,2099,3847,368,850,1218,1112
303031064,447,1168,31,557,745,1333,126,478,604,319
303031065,692,1651,85,928,1287,2300,145,532,677,698
303031066,869,1799,86,1073,1480,2639,257,581,838,629
303041067,431,873,48,565,738,1351,95,401,496,459
303041068,778,1884,66,1198,1539,2803,296,664,960,689
303041069,362,1036,15,297,406,718,86,574,660,320
303041070,508,1094,61,898,1114,2073,151,419,570,498
303041071,775,2084,54,1023,1330,2407,353,718,1071,587
303051072,671,1047,64,1146,1460,2670,90,326,416,602
303051073,1580,3801,136,1708,2303,4147,301,1711,2012,1152
303051074,373,597,25,549,693,1267,72,232,304,253
303051075,1221,2109,153,1777,2294,4224,188,827,1015,679
303051076,553,854,122,1291,1665,3078,69,238,307,944
303061077,557,1406,32,680,945,1657,125,529,654,365
303061078,1238,2382,92,1324,1742,3158,186,1054,1240,865
303061079,646,1547,65,746,1005,1816,142,599,741,561
303061080,1365,2922,106,1555,2123,3784,245,1195,1440,1394
304011081,640,1433,51,793,1122,1966,195,491,686,372
304011082,621,1159,38,845,1118,2001,164,392,556,254
304011083,346,608,38,547,692,1277,86,173,259,200
304011084,764,1880,49,786,1096,1931,235,742,977,664
304011085,386,839,13,416,567,996,135,285,420,181
304021086,959,1719,94,1071,1447,2612,214,626,840,441
304021087,508,1487,33,391,656,1080,211,700,911,557
304021088,747,2421,44,575,851,1470,404,1259,1663,529
304021089,294,924,12,221,299,532,99,440,539,189
304021090,724,1910,47,616,880,1543,281,895,1176,324
304021091,450,1096,13,390,569,972,153,510,663,336
304031092,477,1712,28,446,622,1096,252,696,948,371
304031093,343,1013,22,348,484,854,138,360,498,333
304031094,680,3154,61,695,1012,1768,372,1464,1836,797
304031095,341,1326,21,455,606,1082,172,556,728,306
304031096,680,2718,84,394,648,1126,229,1695,1924,918
304031097,569,2367,52,510,711,1273,261,1105,1366,502
304041098,627,1402,71,976,1222,2269,217,375,592,594
304041099,0,3,0,3,3,6,0,3,3,0
304041100,565,903,55,912,1156,2123,160,232,392,446
304041101,714,1443,53,950,1212,2215,228,444,672,446
304041102,0,0,0,0,0,0,0,0,0,0
304041103,1425,3295,115,1420,1935,3470,547,1162,1709,825
304041104,858,1443,74,1279,1635,2988,248,395,643,413
305011105,817,2677,80,595,886,1561,261,1098,1359,1208
305011106,605,1791,76,723,967,1766,144,548,692,1103
305011107,399,1442,41,423,562,1026,209,685,894,645
305011108,695,2132,55,782,1066,1903,218,741,959,859
305011109,880,3207,66,917,1301,2284,431,1114,1545,2083
305011110,525,1873,35,459,608,1102,165,795,960,749
305011111,423,1663,45,357,523,925,169,552,721,825
305011112,612,2326,58,577,818,1453,335,1135,1470,1019
305021113,328,866,24,412,547,983,132,283,415,273
305021114,537,1393,33,585,767,1385,197,530,727,563
305021115,469,1348,35,529,738,1302,159,400,559,516
305021116,390,1163,23,377,506,906,145,409,554,254
305021117,1117,2629,64,1433,1846,3343,367,672,1039,896
305021118,461,1402,34,610,771,1415,203,404,607,392
305031119,232,624,15,279,373,667,82,183,265,261
305031120,493,1445,36,524,691,1251,225,356,581,313
305031121,436,1154,24,425,598,1047,131,334,465,394
305031122,944,2325,66,845,1158,2069,312,751,1063,744
305031123,286,895,9,335,435,779,146,319,465,173
305031124,526,1361,41,589,775,1405,149,435,584,781
305031125,394,898,26,409,560,995,114,246,360,333
305031126,687,2393,46,626,814,1486,266,947,1213,962
305031127,339,1187,29,467,626,1122,138,361,499,362
305031128,885,2965,55,855,1197,2107,370,1026,1396,1610
305031129,217,970,8,306,371,685,149,329,478,195
305031130,558,1761,60,699,903,1662,246,497,743,498
305031131,756,2175,65,867,1182,2114,292,657,949,711
305041132,891,2955,63,977,1307,2347,464,1124,1588,666
305041133,352,1526,29,356,484,869,193,590,783,490
305041134,588,2363,29,567,777,1373,369,961,1330,475
305041135,730,3066,42,738,1011,1791,353,1009,1362,745
305041136,386,1483,22,465,568,1055,198,500,698,512
305041137,692,3012,49,669,915,1633,326,1255,1581,894
306011138,518,595,29,857,1049,1935,107,138,245,342
306011139,1024,1218,94,1652,2117,3863,181,369,550,979
306011140,320,579,24,551,666,1241,86,152,238,251
306011141,1072,1473,89,1998,2430,4517,234,320,554,986
306011142,1173,1506,120,2349,2939,5408,236,417,653,1110
306011143,504,652,67,1032,1369,2468,99,143,242,893
306021144,518,434,100,1337,1653,3090,64,52,116,594
306021145,999,1613,119,1278,1732,3129,161,385,546,2238
306021146,543,742,85,1394,1675,3154,97,154,251,727
306021147,596,566,126,1920,2372,4418,72,67,139,870
306021148,534,546,92,1616,1923,3631,90,90,180,769
306021149,694,983,92,1457,1853,3402,121,208,329,933
306021150,0,0,0,0,0,0,0,0,0,0
306021151,322,387,99,789,1091,1979,54,59,113,942
306021152,327,349,84,774,1050,1908,43,81,124,814
306021153,631,731,119,1369,1719,3207,105,140,245,482
306021154,429,583,102,832,1152,2086,68,77,145,1122
306021155,257,260,49,784,998,1831,36,44,80,555
306021156,662,1143,82,1173,1520,2775,182,316,498,617
306021157,279,282,79,763,966,1808,29,39,68,578
306031158,214,258,48,792,1003,1843,34,27,61,469
306031159,437,514,109,1390,1777,3276,58,90,148,1175
306031160,415,387,93,1454,1752,3299,69,43,112,814
306031161,560,609,112,1754,2166,4032,86,85,171,1294
306031162,0,0,0,0,0,0,0,0,0,0
306031163,55,37,54,199,282,535,13,0,13,218
306041164,363,414,76,1145,1465,2686,76,71,147,876
306041165,464,560,49,817,1107,1973,53,124,177,847
306051166,697,793,107,1774,2190,4071,105,149,254,1052
306051167,274,242,64,798,1027,1889,41,44,85,923
306051168,374,451,68,750,1005,1823,65,134,199,511
306051169,582,727,93,1452,1808,3353,112,181,293,825
306051170,532,683,105,1543,1948,3596,72,100,172,1380
307011171,277,297,40,504,650,1194,32,28,60,444
307011172,397,475,99,1206,1507,2812,39,46,85,1006
307011173,355,491,61,865,1099,2025,38,50,88,688
307011174,258,258,28,506,651,1185,21,19,40,467
307011175,223,274,50,564,723,1337,15,21,36,561
307011176,382,559,67,1082,1316,2465,76,82,158,774
307011177,384,344,71,735,1006,1812,18,21,39,546
307011178,199,158,66,474,635,1175,6,12,18,849
307021179,551,500,107,1358,1733,3198,71,78,149,836
307021180,375,323,121,1072,1439,2632,32,43,75,666
307021181,144,163,26,440,574,1040,10,22,32,498
307021182,307,316,65,855,1105,2025,42,30,72,592
307021183,852,1051,201,2580,3276,6057,137,102,239,1655
307031184,304,317,51,773,989,1813,49,33,82,445
307031185,243,275,28,599,793,1420,35,44,79,402
307031186,286,284,44,718,909,1671,23,56,79,459
307031187,310,393,62,750,963,1775,37,49,86,531
307031188,365,416,82,892,1244,2218,52,77,129,525
307031189,776,849,208,2291,3010,5509,162,160,322,1310
308011190,257,344,99,1092,1357,2548,54,50,104,894
308011191,371,453,77,1224,1528,2829,43,20,63,1075
308011192,611,986,173,2327,2798,5298,127,138,265,1540
308031205,273,339,95,1099,1338,2532,39,39,78,737
308031206,106,73,9,331,380,720,3,3,6,163
308031207,305,359,47,911,1149,2107,49,45,94,679
308031208,527,818,125,1500,1836,3461,139,160,299,621
308031209,244,340,33,822,953,1808,41,64,105,880
308031210,526,575,146,1964,2414,4524,89,79,168,915
308031211,206,224,62,770,968,1800,33,28,61,367
308031212,132,90,43,421,554,1018,3,6,9,355
308031213,558,939,109,1462,1775,3346,138,244,382,782
308031214,217,270,75,891,1068,2034,36,41,77,477
308031215,310,460,62,1114,1330,2506,66,86,152,703
308031216,285,511,71,932,1166,2169,63,90,153,620
308031217,127,177,34,473,612,1119,16,31,47,503
308031218,194,178,32,669,829,1530,38,47,85,353
308031219,213,277,50,742,923,1715,43,44,87,436
308031220,138,149,25,498,593,1116,21,20,41,308
308031221,0,0,0,5,5,10,0,0,0,0
308031222,401,929,97,975,1274,2346,176,258,434,942
308031223,1044,1496,202,3121,3844,7167,250,295,545,1747
308041528,342,443,86,1183,1548,2817,67,52,119,828
308041529,244,402,57,941,1108,2106,35,51,86,521
308051530,322,287,95,1141,1403,2639,32,49,81,682
308051531,597,720,106,1996,2389,4491,115,108,223,668
308051532,0,0,0,4,3,7,0,0,0,0
308051533,644,1027,149,2645,3085,5879,115,176,291,792
308051534,308,461,76,1069,1312,2457,49,104,153,792
308051535,552,553,123,2411,2860,5394,58,61,119,1115
308051536,197,200,46,751,879,1676,43,28,71,242
308051537,0,0,0,0,0,0,0,0,0,0
308051538,295,422,80,1243,1469,2792,54,50,104,427
308051539,214,387,66,872,1030,1968,51,75,126,462
309011224,740,981,46,1165,1515,2726,107,261,368,719
309011225,790,1225,69,1317,1702,3088,163,298,461,1019
309011226,1166,1516,113,2205,2819,5137,187,345,532,1002
309011227,1051,1865,82,1637,2168,3887,196,462,658,1700
309011228,1049,1433,111,1822,2355,4288,141,311,452,1002
309011229,616,1008,58,1113,1440,2611,111,196,307,740
309021230,471,694,29,904,1178,2111,76,146,222,872
309021231,1029,1326,90,1776,2315,4181,165,270,435,1337
309021232,734,710,84,1633,2061,3778,101,138,239,625
309021233,993,1103,82,2130,2673,4885,161,231,392,870
309021234,1175,1681,138,2558,3150,5846,204,350,554,1270
309031235,777,1015,85,1473,1934,3492,111,404,515,841
309031236,738,946,69,1203,1608,2880,76,253,329,999
309031237,774,648,93,1765,2319,4177,80,164,244,1112
309031238,1440,1671,194,2775,3668,6637,170,459,629,2303
309031239,823,1001,74,1495,2003,3572,103,266,369,839
309031240,839,981,64,1383,1865,3312,119,232,351,936
309041241,371,395,45,722,951,1718,57,104,161,481
309041242,1252,1485,145,2289,3016,5450,236,423,659,1513
309051243,607,762,46,1193,1543,2782,89,230,319,532
309051244,1553,1812,145,2903,3681,6729,314,481,795,1254
309051245,691,874,57,1174,1503,2734,104,221,325,433
309061246,1019,1238,94,2020,2552,4666,171,263,434,1013
309061247,688,674,87,1458,1823,3368,90,118,208,613
309061248,1583,1505,216,3499,4399,8114,233,306,539,1792
309061249,1494,1484,183,2923,3763,6869,197,390,587,1135
309061250,632,816,55,1245,1633,2933,94,225,319,779
309071251,1082,1047,129,2044,2615,4788,126,218,344,958
309071252,1448,1515,139,2684,3501,6324,194,366,560,1376
309071253,1083,1287,66,1524,2119,3709,144,384,528,1317
309071254,198,187,23,768,961,1752,17,41,58,304
309071255,1564,1445,160,3182,4018,7360,172,285,457,1250
309071256,1285,1272,155,2821,3500,6476,154,282,436,1106
309071257,675,512,114,1500,1916,3530,63,104,167,866
309071258,2412,2233,289,5186,6457,11932,315,522,837,2003
309081259,372,518,25,461,671,1157,52,179,231,423
309081260,571,629,66,1010,1299,2375,62,120,182,863
309081261,2184,2763,153,3116,4141,7410,317,837,1154,1795
309081262,1297,1784,122,2043,2655,4820,188,537,725,1344
309091263,1049,1216,118,1737,2259,4114,127,314,441,1047
309091264,492,713,52,927,1185,2164,70,180,250,425
309091265,652,952,77,1275,1670,3022,97,284,381,647
309091540,1277,1876,134,1788,2403,4325,164,602,766,1777
309091541,1555,2098,136,2161,2897,5194,200,674,874,2024
309101267,761,1171,54,966,1339,2359,127,347,474,848
309101268,406,638,39,542,721,1302,75,176,251,359
309101269,339,647,25,422,583,1030,73,184,257,647
309101270,2183,3344,201,2805,3864,6870,282,836,1118,4137
310011271,340,536,46,563,725,1334,65,144,209,509
310011272,510,826,59,859,1129,2047,61,228,289,772
310011273,2165,3161,260,3337,4432,8029,378,1077,1455,1793
310011274,774,919,200,1625,2268,4093,64,195,259,2008
310011275,555,1270,66,845,1121,2032,204,427,631,650
310011276,136,128,18,320,407,745,4,36,40,3231
310021277,742,768,137,1845,2365,4347,110,115,225,1065
310021278,329,293,62,797,1082,1941,57,37,94,532
310021279,0,0,0,0,0,0,0,0,0,0
310021280,1084,862,246,3083,3940,7269,139,153,292,2452
310021281,752,624,171,2330,2973,5474,107,95,202,1371
310021282,774,558,140,2068,2629,4837,86,125,211,1322
310031283,684,648,169,1760,2242,4171,107,125,232,728
310031284,536,469,118,1435,1868,3421,83,82,165,924
310031285,441,355,70,1302,1604,2976,44,57,101,390
310031286,459,620,60,922,1198,2180,106,136,242,608
310031287,1162,1235,217,2863,3617,6697,186,254,440,1517
310031288,350,435,35,831,997,1863,77,96,173,225
310031289,458,542,33,1007,1227,2267,90,118,208,302
310031290,595,881,49,848,1076,1973,150,306,456,249
310031291,369,281,134,1130,1520,2784,35,45,80,836
310031292,422,323,82,1096,1412,2590,66,69,135,593
310031293,968,884,202,2647,3268,6117,124,138,262,926
310031294,329,361,59,926,1083,2068,36,62,98,322
310031295,158,109,27,377,533,937,9,24,33,409
310041296,1099,1430,151,2065,2605,4821,155,368,523,825
310041297,643,561,112,1622,2066,3800,85,120,205,730
310041298,0,0,0,0,0,0,0,0,0,0
310041299,554,443,105,1260,1675,3040,79,81,160,597
310041300,611,539,154,1312,1823,3289,84,126,210,1076
310041301,0,0,0,0,0,0,0,0,0,0
310041302,1100,824,241,2832,3684,6757,106,174,280,1361
310041303,464,569,58,1051,1295,2404,71,127,198,346
310041304,1237,1788,149,2115,2690,4954,182,527,709,781
311011305,775,643,169,2071,2710,4950,101,117,218,1525
311021306,434,360,133,1325,1763,3221,40,68,108,825
311021307,771,505,195,1999,2660,4854,61,65,126,1263
311021308,521,495,106,1207,1566,2879,76,84,160,453
311021309,407,349,58,1019,1263,2340,46,60,106,416
311021310,445,421,59,1096,1452,2607,69,82,151,348
311031311,652,597,138,2047,2567,4752,64,100,164,991
311031312,437,470,69,1164,1420,2653,34,127,161,595
311031313,309,306,46,893,1097,2036,23,55,78,385
311031314,537,359,153,1717,2232,4102,44,48,92,1035
311031315,0,0,0,0,0,0,0,0,0,0
311031316,547,610,69,1399,1749,3217,74,121,195,461
311031317,689,492,175,1898,2472,4545,53,104,157,1398
311031318,278,288,43,907,1082,2032,37,38,75,238
311031319,1057,957,178,2626,3367,6171,136,185,321,889
311041320,859,771,108,2448,2989,5545,136,135,271,721
311041321,1701,1325,311,4845,6025,11181,186,217,403,1819
311041322,463,401,60,1386,1692,3138,69,69,138,530
311051323,683,627,139,1725,2203,4067,93,127,220,1051
311051324,719,911,75,1473,1832,3380,119,194,313,457
311051325,787,777,96,2063,2537,4696,120,140,260,792
311051326,592,627,150,1524,2024,3698,78,140,218,1067
311051327,961,1282,94,2016,2562,4672,175,309,484,609
311051328,378,315,113,1109,1445,2667,34,62,96,672
311061329,581,812,51,1007,1256,2314,123,219,342,378
311061330,474,337,165,1373,1794,3332,43,71,114,1185
311061331,271,198,74,663,920,1657,16,37,53,600
311061332,1281,1912,138,2388,2958,5484,242,453,695,801
311061333,613,581,139,1486,1958,3583,59,141,200,836
311061334,742,1034,92,1362,1735,3189,132,293,425,656
311061335,500,961,36,682,884,1602,90,305,395,351
311061336,620,547,210,1463,2026,3699,63,159,222,1083
312011337,414,436,109,1475,1839,3423,69,61,130,1209
312011338,304,430,77,1460,1723,3260,54,53,107,1523
312011339,129,239,43,571,707,1321,16,16,32,456
312011340,94,138,47,515,648,1210,8,7,15,492
312011341,375,663,115,1611,1924,3650,71,96,167,983
312021342,768,906,176,2951,3491,6618,127,105,232,1053
312021343,207,288,24,613,758,1395,34,51,85,393
312021344,710,1005,122,2352,2815,5289,155,174,329,964
312021345,0,0,0,0,0,0,0,0,0,0
312021346,189,364,27,533,627,1187,29,82,111,523
312021347,47,74,0,85,91,176,3,25,28,75
312021348,647,1010,97,1883,2269,4249,130,180,310,895
312021349,284,397,41,1129,1348,2518,60,54,114,716
312021350,197,330,54,1022,1178,2254,48,47,95,459
312021351,309,370,85,1579,1880,3544,62,31,93,879
312021352,494,424,128,2218,2696,5042,74,50,124,1350
312021353,392,388,59,1522,1871,3452,64,60,124,886
312021354,354,362,56,1159,1359,2574,60,53,113,362
312021355,198,188,26,612,750,1388,28,41,69,273
312021356,301,423,83,1295,1525,2903,50,45,95,592
312021357,355,396,85,1687,1959,3731,35,55,90,860
312021358,317,574,60,1055,1240,2355,66,88,154,731
312031359,1128,1077,171,2336,2943,5450,122,162,284,2178
312031360,0,0,0,0,0,0,0,0,0,0
312031361,477,370,93,1632,2023,3748,55,40,95,939
313011362,998,754,154,2794,3500,6448,131,157,288,1409
313011363,1400,1176,189,3068,4011,7268,225,267,492,1958
313021364,290,228,19,824,995,1838,26,31,57,194
313021365,1580,1318,383,4414,5626,10423,179,208,387,2887
313021366,1250,819,298,3367,4311,7976,111,135,246,1569
313021367,228,216,54,785,979,1818,46,32,78,291
313021368,516,333,108,1512,1916,3536,52,49,101,579
313021369,263,273,41,736,866,1643,41,62,103,362
313031370,307,309,60,783,1067,1910,50,40,90,572
313031371,439,344,75,1221,1510,2806,68,69,137,1771
313041372,1011,798,175,2608,3253,6036,149,122,271,912
313041373,1325,1001,272,3693,4676,8641,135,127,262,2283
313041374,371,324,51,949,1164,2164,46,54,100,296
313041375,1453,1322,165,3380,4094,7639,236,221,457,868
313041376,228,186,22,610,706,1338,25,25,50,209
313051377,628,629,81,1437,1768,3286,95,113,208,780
313051378,942,1015,110,2023,2613,4746,161,255,416,872
313051379,791,748,114,1644,2128,3886,109,194,303,1194
313051380,1124,1013,193,2708,3515,6416,141,151,292,1680
313051542,1125,1295,85,1910,2518,4513,220,343,563,1046
314011382,1476,2020,115,2261,2846,5222,315,470,785,813
314011383,1733,2079,145,3056,3764,6965,256,448,704,637
314011384,731,957,80,1300,1672,3052,165,222,387,642
314011385,789,1042,49,1152,1441,2642,167,238,405,337
314011386,1984,3523,176,3303,4180,7659,665,831,1496,943
314011387,1079,1991,56,1367,1830,3253,331,633,964,695
314021388,1618,1402,285,4263,5337,9885,188,215,403,1647
314021389,1503,1536,176,2878,3641,6695,199,310,509,1057
314021390,2592,3264,321,4330,5559,10210,437,806,1243,1614
314031391,713,636,109,1848,2239,4196,123,102,225,677
314031392,442,399,92,1039,1335,2466,80,79,159,484
314031393,726,763,107,1489,1878,3474,150,159,309,518
314031394,878,833,156,2078,2621,4855,108,174,282,832
315011395,22,29,18,99,135,252,0,6,6,53
315011396,313,313,141,1039,1393,2573,67,48,115,1137
315011397,42,38,9,127,162,298,0,6,6,162
315011398,23,25,30,149,216,395,10,6,16,114
315011399,125,89,86,355,476,917,12,8,20,203
315011400,257,268,67,785,1004,1856,21,31,52,1636
315011401,172,215,83,398,589,1070,39,61,100,669
315011402,123,77,195,571,869,1635,16,3,19,581
315011403,173,296,29,851,977,1857,42,59,101,392
315021404,150,162,52,406,576,1034,27,31,58,599
315021405,749,1318,187,3241,3796,7224,182,257,439,2073
315021406,142,213,28,494,599,1121,13,42,55,488
315021407,127,182,42,427,586,1055,26,17,43,331
315031408,240,314,46,635,825,1506,32,35,67,407
315031409,190,295,47,513,645,1205,39,29,68,418
315031410,81,119,23,301,370,694,14,22,36,251
315031411,152,129,29,401,509,939,22,21,43,248
315031412,244,287,50,494,655,1199,50,51,101,415
316011413,1538,2169,130,2410,3171,5711,332,529,861,1429
316011414,1494,2115,148,2459,3184,5791,314,539,853,1129
316011415,958,1144,112,1857,2364,4333,153,231,384,605
316011416,765,903,125,1593,2077,3795,115,213,328,783
316021417,730,834,106,1848,2359,4313,160,141,301,603
316021418,521,774,31,1126,1380,2537,85,177,262,453
316021419,540,606,57,1087,1425,2569,110,156,266,919
316021420,1632,1531,232,3595,4504,8331,198,240,438,1288
316021421,1005,1065,119,1994,2606,4719,162,271,433,932
316021422,625,954,59,1219,1557,2835,138,193,331,579
316021423,739,1005,93,1472,2009,3574,116,199,315,771
316021424,569,752,74,1393,1778,3245,122,151,273,598
316031425,1280,1743,136,2523,3176,5835,279,388,667,1120
316031426,941,1105,104,1953,2486,4543,179,235,414,764
316031427,1507,1935,191,3262,4201,7654,254,449,703,2092
316031428,1012,1518,114,1809,2370,4293,184,325,509,1462
316051434,508,677,27,547,799,1373,69,144,213,461
316051435,859,996,79,1378,1872,3329,158,238,396,863
316051437,629,920,54,913,1204,2171,153,260,413,549
316051438,882,754,103,1765,2294,4162,118,123,241,1108
316051543,359,591,37,550,748,1335,85,166,251,250
316051544,717,794,58,1002,1319,2379,109,170,279,543
316061439,556,517,75,1423,1859,3357,87,68,155,707
316061440,913,1099,76,1238,1654,2968,238,373,611,700
316061441,445,405,56,1073,1388,2517,58,66,124,457
316061442,784,755,117,1914,2392,4423,138,174,312,800
316061443,591,710,57,1000,1341,2398,123,160,283,585
316061444,973,1105,105,1753,2266,4124,213,234,447,721
316071545,692,704,91,1565,1974,3630,107,142,249,635
316071546,287,334,23,663,835,1521,74,88,162,306
316071547,846,1048,63,1909,2315,4287,165,229,394,876
316071548,1448,1518,241,3510,4368,8119,239,267,506,1673
316081549,1911,2131,202,3764,4830,8796,352,480,832,1779
317011445,490,612,52,1156,1406,2614,91,153,244,531
317011446,846,1613,155,1709,2204,4068,146,639,785,1106
317011447,594,731,116,1606,2037,3759,78,174,252,970
317011448,326,525,91,812,1127,2030,31,137,168,760
317011449,427,380,58,1275,1523,2856,57,74,131,382
317011450,1090,1550,129,2008,2538,4675,278,341,619,759
317011451,696,786,148,1785,2276,4209,117,179,296,994
317011452,506,1000,55,790,1028,1873,136,347,483,661
317011453,533,717,137,1565,1959,3661,87,147,234,897
317011454,318,503,79,942,1177,2198,86,116,202,560
317011455,632,1190,77,1061,1393,2531,202,362,564,639
317011456,859,1491,171,1994,2571,4736,213,334,547,1287
317011457,741,1585,77,1086,1417,2580,271,544,815,787
317011458,817,991,128,2327,2807,5262,133,194,327,900
317011459,696,717,185,2068,2692,4945,86,94,180,1227
318011460,359,531,87,1545,1830,3462,49,49,98,859
318011461,335,347,72,1355,1651,3078,45,37,82,726
318011462,330,464,90,1004,1285,2379,87,63,150,877
318011463,149,147,27,570,710,1307,9,20,29,477
318011464,196,194,54,733,859,1646,15,31,46,484
318011465,263,346,51,1230,1456,2737,40,36,76,659
318011466,33,47,93,172,272,537,10,11,21,107
318021467,257,527,42,685,874,1601,64,147,211,380
318021468,667,1164,103,1338,1637,3078,158,380,538,1017
318021469,234,466,6,405,520,931,63,148,211,330
318021470,480,606,58,1425,1634,3117,83,116,199,345
318021471,550,593,125,1780,2185,4090,64,92,156,846
318021472,402,562,52,924,1123,2099,77,175,252,470
318021473,1395,1539,224,4447,5206,9877,205,261,466,1428
318021474,464,1162,93,833,1040,1966,119,363,482,494
318021475,403,599,56,999,1200,2255,80,155,235,876
318021476,411,562,95,1380,1657,3132,81,102,183,588
318021477,211,241,59,643,797,1499,29,46,75,328
318021478,365,588,65,790,970,1825,92,150,242,472
318021479,329,536,43,693,819,1555,70,118,188,391
318021480,604,526,137,1777,2179,4093,86,71,157,885
318021481,419,445,114,1307,1631,3052,59,74,133,584
318021482,1063,1303,172,2668,3218,6058,187,199,386,1032
318021483,205,264,13,407,496,916,50,74,124,323
318021484,648,858,79,1720,2007,3806,100,129,229,562
318021485,256,431,27,461,541,1029,69,119,188,394
318021486,343,347,56,1308,1564,2928,50,62,112,676
318021487,418,849,66,944,1145,2155,96,216,312,454
318021488,337,591,34,814,1029,1877,98,141,239,723
318021489,279,329,38,825,995,1858,42,98,140,394
318021490,654,1675,71,1131,1430,2632,210,547,757,1127
318021491,260,296,43,852,1057,1952,36,48,84,1375
319011492,277,308,53,886,1065,2004,39,40,79,476
319011493,1103,1511,191,2808,3546,6545,232,333,565,1143
319011494,252,295,51,845,1010,1906,40,31,71,314
319011495,315,438,114,842,1159,2115,38,92,130,793
319011496,261,385,94,916,1141,2151,49,69,118,459
319011497,328,391,103,1086,1467,2656,50,43,93,817
319011498,456,422,100,1516,1912,3528,67,66,133,1083
319011499,553,492,119,1649,2064,3832,83,67,150,1163
319011500,332,428,100,1123,1445,2668,64,60,124,780
319011501,247,331,77,932,1209,2218,38,27,65,452
319011502,500,516,143,1739,2234,4116,79,74,153,939
319021503,315,327,93,849,1132,2074,33,36,69,909
319021504,231,212,83,778,1055,1916,11,23,34,644
319021505,612,667,180,1591,2072,3843,98,84,182,858
319021506,457,407,117,1216,1607,2940,72,60,132,1093
319021507,243,249,32,666,831,1529,32,26,58,380
319021508,164,176,42,473,666,1181,26,16,42,564
319021509,455,411,137,1515,2034,3686,47,59,106,1199
319021510,0,0,0,0,0,0,0,0,0,0
319031511,375,264,66,1084,1418,2568,49,43,92,846
319031512,812,710,219,2345,2968,5532,107,104,211,1465
319031513,372,404,85,1106,1371,2562,74,55,129,541
319031514,1250,1081,263,3296,4218,7777,179,177,356,1937
319031515,190,152,59,539,708,1306,34,16,50,414
319041516,270,236,65,935,1215,2215,44,59,103,402
319041517,352,366,45,952,1216,2213,53,87,140,361
319041518,859,903,161,2206,2849,5216,131,200,331,1484
319041519,384,410,72,922,1181,2175,68,54,122,615
319041520,918,931,177,2468,3241,5886,174,150,324,1744
319041521,890,834,138,2167,2758,5063,162,111,273,1127
319051522,495,414,130,1711,2231,4072,67,61,128,1183
319051523,126,104,41,557,696,1294,20,9,29,333
319051524,934,796,263,2893,3694,6850,149,139,288,2315
319051525,448,348,114,1568,2026,3708,44,52,96,1130
319051526,368,318,67,1018,1278,2363,56,40,96,459
397979799,10,6,0,13,19,32,0,0,0,17
399999499,773,1137,115,1891,2418,4424,108,276,384,2887
401011001,1205,3502,92,805,1259,2156,304,1418,1722,2036
401011002,471,1556,45,436,695,1176,200,773,973,814
401021003,630,677,50,1227,1547,2824,107,160,267,511
401021004,1537,3476,109,1694,2386,4189,638,1236,1874,905
401021005,381,607,31,617,837,1485,92,156,248,325
401021006,736,1001,110,1376,1788,3274,136,235,371,651
401021007,1433,1724,230,2684,3628,6542,291,381,672,1170
401021008,472,616,83,1074,1415,2572,112,160,272,529
401021009,413,491,83,818,1094,1995,75,93,168,268
401021010,419,958,24,599,805,1428,157,338,495,288
401031011,1449,4148,104,1181,1767,3052,566,1620,2186,985
401031012,768,2144,47,479,778,1304,283,900,1183,576
401031013,1255,3705,72,874,1427,2373,505,1495,2000,1049
401041014,799,1335,60,1228,1544,2832,204,333,537,353
401041015,1363,2508,154,2316,2976,5446,241,796,1037,1298
401041016,1620,3638,153,2129,2914,5196,492,1246,1738,1236
401051017,803,2338,73,676,1006,1755,316,998,1314,846
401051018,876,2141,85,1243,1682,3010,285,651,936,753
401051019,972,2859,94,979,1389,2462,452,1089,1541,719
401061020,485,1199,46,591,795,1432,149,371,520,341
401061021,1087,2674,92,1411,1844,3347,402,885,1287,889
401061022,605,1651,42,531,808,1381,215,624,839,522
401071023,1328,3820,93,1311,1892,3296,584,1507,2091,1137
401071024,1517,4564,87,1321,1930,3338,704,1714,2418,1329
402011025,686,558,129,1641,2062,3832,92,118,210,570
402011026,1437,1292,304,3236,4181,7721,221,256,477,1574
402011027,308,205,75,1005,1231,2311,37,36,73,458
402021028,1124,872,297,3178,4070,7545,98,123,221,1012
402021029,658,416,375,2483,3343,6201,51,79,130,1504
402021030,330,289,216,1231,1716,3163,28,49,77,1232
402021031,677,566,242,1969,2596,4807,66,64,130,1189
402021032,743,542,202,2094,2602,4898,68,105,173,685
402021033,202,221,17,450,540,1007,44,69,113,207
402021034,423,296,292,1638,2302,4232,30,38,68,1214
402021035,181,182,59,510,653,1222,0,25,25,428
402031036,1430,2660,246,2531,3340,6117,264,840,1104,1843
402031037,1721,3212,247,2937,3867,7051,352,1086,1438,2492
402031038,1507,3244,202,2176,2934,5312,360,1184,1544,1254
402041039,0,0,0,0,0,0,0,0,0,0
402041040,895,1174,195,2323,3034,5552,141,306,447,970
402041041,959,1081,214,2528,3149,5891,130,230,360,893
402041042,6,51,0,0,0,0,0,5,5,0
402041043,820,1160,219,2188,2918,5325,84,302,386,1061
402041044,818,704,255,2491,3190,5936,73,116,189,955
402041046,779,857,278,2435,3252,5965,73,187,260,1477
402041047,1099,943,244,3069,3959,7272,129,187,316,1133
402041048,754,648,277,2441,3242,5960,68,110,178,1247
402041171,1088,1965,109,1514,1961,3584,217,892,1109,786
402041172,470,622,66,1064,1340,2470,49,196,245,547
402051049,932,1077,103,1528,1971,3602,172,243,415,633
402051050,727,809,119,1534,1963,3616,100,163,263,401
402051051,876,1492,90,1496,1915,3501,229,378,607,500
402051052,1162,1703,199,2465,3202,5866,195,482,677,1131
402051053,1596,1830,223,3193,4060,7476,313,454,767,993
402051054,1299,1483,159,2972,3696,6827,240,274,514,912
402051055,1069,1251,158,2159,2802,5119,184,246,430,726
403011056,1232,2209,103,1639,2322,4064,365,659,1024,1089
403011057,1825,3311,174,2284,3227,5685,455,983,1438,1766
403021058,1032,2021,154,1646,2155,3955,249,584,833,980
403021059,1164,1548,147,2050,2714,4911,199,406,605,582
403021060,848,1261,78,1391,1821,3290,175,400,575,562
403021061,1074,2070,160,1740,2328,4228,222,638,860,1119
403021062,1076,1981,155,1904,2537,4596,282,483,765,1086
403021063,895,1062,89,1761,2178,4028,122,192,314,472
403021064,1128,1985,185,1993,2645,4823,264,545,809,1123
403031065,427,970,23,400,607,1030,142,380,522,280
403031066,623,1428,64,771,1035,1870,186,529,715,437
403031067,1066,2239,98,1276,1767,3141,433,742,1175,559
403031068,1237,2790,111,1651,2168,3930,464,828,1292,805
403031069,1233,3591,78,1095,1654,2827,548,1298,1846,828
403031070,621,1247,60,922,1216,2198,178,399,577,591
403041071,1035,1428,139,1928,2533,4600,181,314,495,517
403041072,1107,985,239,2697,3557,6493,201,201,402,1317
403041073,436,414,166,1551,2052,3769,58,74,132,924
403041074,672,661,150,1758,2333,4241,122,122,244,1158
403041075,252,354,28,388,541,957,63,103,166,128
403041076,391,733,32,542,709,1283,136,244,380,182
403041077,1005,1441,95,1535,1982,3612,240,439,679,530
403041078,409,358,93,1283,1615,2991,56,58,114,371
403041079,405,287,150,1322,1764,3236,57,54,111,647
403041080,1184,1393,153,2505,3228,5886,217,217,434,716
403041081,0,0,0,0,0,0,0,0,0,0
403041082,0,0,0,5,5,10,0,0,0,0
403041083,510,558,74,1027,1354,2455,100,103,203,483
403041084,892,798,230,2571,3271,6072,116,118,234,921
403041085,538,474,162,1813,2339,4314,63,85,148,733
403041086,724,751,159,1953,2472,4584,95,115,210,599
403041087,1657,1616,342,4124,5231,9697,253,302,555,1575
403041088,287,407,31,501,650,1182,77,71,148,217
403041089,907,854,156,2077,2612,4845,123,134,257,596
404011090,543,883,83,1157,1451,2691,87,202,289,551
404011091,1036,1658,105,1839,2403,4347,185,397,582,914
404011092,1211,2110,119,1862,2399,4380,260,621,881,934
404011093,1209,2896,144,1965,2541,4650,391,795,1186,1284
404011094,361,501,71,915,1186,2172,54,78,132,478
404011095,1139,1742,172,2153,2861,5186,217,451,668,1327
404011096,1203,1592,134,2062,2803,4999,239,422,661,1078
404011097,1143,1963,172,2247,2884,5303,210,484,694,1219
404021098,0,0,0,0,0,0,0,0,0,0
404021099,1130,1639,153,2230,2878,5261,346,496,842,1010
404021100,985,1006,185,2506,3206,5897,146,202,348,1068
404021101,671,911,157,1544,2045,3746,115,190,305,888
404021102,981,1789,192,1760,2362,4314,123,468,591,1487
404021103,0,0,0,0,0,0,0,0,0,0
404031104,0,0,0,0,0,0,0,0,0,0
404031105,224,353,20,345,477,842,38,72,110,190
404031106,1010,1896,134,1551,2071,3756,218,605,823,776
404031107,1881,3582,226,2789,3726,6741,421,1251,1672,1876
404031108,1138,2788,155,1814,2373,4342,346,794,1140,1135
404031109,421,779,40,675,878,1593,103,200,303,301
405011110,447,493,89,991,1347,2427,102,100,202,491
405011111,542,625,133,1581,2049,3763,100,70,170,602
405011112,505,488,57,1112,1430,2599,69,84,153,465
405011113,133,110,48,521,708,1277,15,11,26,306
405011114,434,411,87,1075,1438,2600,55,65,120,442
405011115,361,470,48,609,840,1497,68,111,179,412
405021116,241,359,44,634,847,1525,60,45,105,324
405021117,356,393,70,755,986,1811,60,60,120,436
405021118,256,215,74,590,795,1459,28,32,60,408
405021119,485,474,106,1376,1798,3280,50,53,103,877
405031120,274,303,59,697,884,1640,43,35,78,399
405031121,298,296,75,782,1003,1860,50,24,74,573
405031122,586,573,202,2190,2751,5143,80,81,161,1218
405031123,184,196,40,550,731,1321,21,9,30,245
405041124,241,216,91,795,1066,1952,51,17,68,614
405041125,263,258,41,833,1075,1949,35,24,59,458
405041126,199,181,45,604,870,1519,9,10,19,450
405041127,394,391,68,1142,1434,2644,56,25,81,684
405041128,238,172,30,696,870,1596,26,18,44,383
406011129,116,159,28,351,441,820,12,23,35,339
406011130,357,406,57,932,1277,2266,67,47,114,632
406011131,217,201,28,657,807,1492,22,25,47,382
406011132,93,149,15,270,365,650,14,10,24,216
406011133,832,1000,233,2561,3338,6132,164,125,289,1677
406011134,155,179,40,476,628,1144,27,6,33,463
406011135,0,0,0,3,3,6,0,0,0,37
406011136,975,1187,375,3935,4897,9207,132,197,329,2019
406011137,0,0,0,0,0,0,0,0,0,0
406021138,44,73,13,122,175,310,8,23,31,389
406021139,92,113,3,250,284,537,11,33,44,335
406021140,105,115,19,344,432,795,18,19,37,265
406021141,133,148,38,490,603,1131,20,17,37,516
406021142,553,655,198,2036,2618,4852,115,100,215,2030
406021143,171,293,55,843,999,1897,37,57,94,318
407011144,869,840,145,1842,2541,4528,174,166,340,1177
407011145,283,379,64,681,897,1642,60,86,146,563
407011146,570,542,104,1181,1561,2846,75,79,154,620
407011147,580,585,83,1326,1732,3141,99,88,187,717
407011148,1123,1091,203,2350,3215,5768,179,222,401,1384
407011149,485,420,92,953,1233,2278,74,108,182,554
407021150,249,260,69,894,1179,2142,38,51,89,928
407021151,211,228,59,597,791,1447,50,23,73,420
407021152,209,215,91,874,1121,2086,19,17,36,526
407021154,281,370,89,877,1196,2162,45,32,77,532
407021155,177,166,26,289,418,733,18,18,36,123
407021156,138,201,38,437,614,1089,31,31,62,261
407021157,400,375,81,947,1271,2299,43,30,73,693
407021158,176,178,46,522,692,1260,37,22,59,258
407021173,740,881,242,2411,3175,5828,123,161,284,1109
407021174,649,792,232,2396,3088,5716,118,134,252,1077
407031159,330,328,89,979,1335,2403,28,30,58,594
407031160,212,253,59,535,762,1356,41,45,86,425
407031161,152,172,42,390,503,935,21,8,29,294
407031162,318,324,70,836,1062,1968,48,34,82,433
407031163,95,92,15,245,300,560,12,0,12,151
407031164,324,291,84,1026,1326,2436,40,55,95,712
407031165,829,760,312,2567,3476,6355,118,116,234,1850
407031166,200,175,45,645,856,1546,31,21,52,341
407031167,237,235,35,570,746,1351,20,31,51,539
407031168,296,229,53,753,992,1798,42,27,69,434
407031169,287,230,91,761,1030,1882,28,26,54,476
407031170,332,275,95,1058,1332,2485,41,30,71,854
497979799,0,0,0,0,0,0,0,0,0,0
499999499,144,213,30,415,537,982,19,55,74,684
501011001,377,600,78,874,1153,2105,87,78,165,565
501011002,1750,1892,325,4512,5863,10700,298,283,581,2530
501011003,870,1362,112,1557,2069,3738,174,188,362,909
501011004,696,1153,84,1373,1758,3215,141,176,317,797
501021005,1128,1226,237,3167,4058,7462,181,173,354,1388
501021007,324,364,78,902,1162,2142,55,43,98,447
501021008,328,382,103,1059,1441,2603,70,39,109,1008
501021009,369,307,140,1661,2113,3914,32,28,60,949
501021010,225,268,50,545,706,1301,28,25,53,233
501021011,0,0,0,0,0,0,0,0,0,0
501021012,669,689,156,2245,2803,5204,102,94,196,997
501021014,473,521,93,1480,1870,3443,64,46,110,1000
501021015,381,431,109,1300,1663,3072,50,66,116,559
501021016,209,162,46,719,886,1651,25,17,42,549
501021251,586,802,149,1458,1904,3511,124,141,265,594
501021252,238,325,30,532,700,1262,52,56,108,210
501021253,956,1403,157,1911,2515,4583,237,294,531,1127
501021254,252,256,75,842,1075,1992,42,37,79,511
501031017,428,484,89,1033,1349,2471,67,55,122,680
501031018,418,435,68,917,1221,2206,71,69,140,688
501031019,249,262,91,855,1095,2041,44,45,89,519
501031020,335,387,62,701,958,1721,60,57,117,585
502011021,529,467,83,1341,1710,3134,82,80,162,573
502011022,682,652,111,1644,2109,3864,83,80,163,738
502011023,547,455,135,1641,2135,3911,57,78,135,889
502011024,1458,1376,207,3113,4021,7341,193,246,439,1615
502011025,580,636,133,1417,1900,3450,81,132,213,1168
502011026,369,277,85,1102,1409,2596,45,42,87,503
502011027,1271,1264,202,3296,4127,7625,196,259,455,1229
502011028,631,482,115,1664,2246,4025,80,106,186,1205
502011029,474,399,124,1640,2125,3889,61,44,105,1017
503011030,509,1632,13,288,455,756,179,595,774,423
503011031,605,2150,29,370,605,1004,241,758,999,867
503011032,562,2141,24,343,549,916,226,728,954,576
503011033,543,2058,40,343,510,893,275,683,958,331
503011034,733,2526,49,546,847,1442,291,871,1162,969
503011035,1068,5171,70,511,894,1475,513,2346,2859,1131
503011036,648,2079,27,355,575,957,282,797,1079,591
503021037,0,0,0,0,0,0,0,3,3,3
503021038,799,2597,64,871,1214,2149,401,781,1182,676
503021039,1366,3808,128,1328,1824,3280,565,1101,1666,1541
503021040,650,2035,55,735,1028,1818,284,556,840,760
503021041,2612,8134,185,2462,3378,6025,738,2868,3606,5257
503021042,1138,4373,58,827,1291,2176,618,1882,2500,1521
503021043,1439,4316,75,1238,1749,3062,537,1504,2041,1654
504011044,1135,1930,153,2132,2704,4989,319,460,779,1182
504011045,1860,3775,185,2706,3593,6484,549,950,1499,1961
504011046,1091,2734,103,1378,1834,3315,340,853,1193,1317
504011047,1620,2582,209,3059,3987,7255,266,613,879,1681
504011048,656,1025,52,1012,1348,2412,133,193,326,555
504021049,214,193,14,556,702,1272,27,31,58,2138
504021050,664,1119,48,874,1187,2109,247,343,590,423
504021051,429,474,67,937,1204,2208,87,96,183,333
504021052,0,0,0,0,0,0,0,0,0,0
504021053,1054,1311,109,2211,2850,5170,243,258,501,1011
504021054,834,853,130,1978,2518,4626,145,161,306,1102
504031055,0,0,0,0,0,0,0,0,0,0
504031056,1182,1500,205,2778,3578,6561,167,252,419,1083
504031057,1158,1526,204,2506,3224,5934,134,303,437,1701
504031058,306,295,79,943,1242,2264,37,33,70,592
504031059,2739,2904,446,5676,7105,13227,339,616,955,2524
504031060,246,244,26,476,617,1119,39,70,109,207
504031061,323,444,38,656,879,1573,64,90,154,315
504031062,729,998,117,1570,2023,3710,118,208,326,897
504031063,0,0,0,0,0,0,0,0,0,0
504031064,0,0,0,0,0,0,0,0,0,0
504031065,365,358,60,865,1102,2027,46,69,115,507
504031066,706,1007,157,1402,1887,3446,149,255,404,1538
504031067,437,400,79,1087,1437,2603,56,69,125,489
504031068,847,956,118,1606,2071,3795,148,198,346,634
504031069,0,0,0,0,0,0,0,0,0,0
505011070,697,1042,106,1846,2281,4233,133,171,304,644
505011071,1175,1557,176,2241,2870,5287,213,313,526,692
505011072,1376,2661,103,1709,2341,4153,426,669,1095,808
505011073,1116,1800,133,2038,2700,4871,289,352,641,811
505011074,933,1099,98,1855,2345,4298,147,221,368,652
505011075,1039,1808,60,1317,1798,3175,214,417,631,557
505011076,836,1234,77,1224,1593,2894,183,301,484,372
505011077,1274,1820,169,2032,2654,4855,257,485,742,1005
505011078,1139,1750,94,1886,2502,4482,245,331,576,837
505011079,1020,1602,81,1578,2075,3734,230,358,588,812
505011080,729,1089,49,1135,1538,2722,143,247,390,461
505011081,640,1075,69,1394,1727,3190,150,202,352,473
505011082,906,1740,72,1084,1519,2675,258,424,682,595
505011083,875,1254,90,1316,1766,3172,179,245,424,387
505021084,1229,1998,114,2106,2729,4949,259,384,643,1330
505021085,1278,1580,248,2212,3155,5615,133,356,489,1881
505021086,1885,3723,153,2634,3621,6408,486,867,1353,1715
505021087,0,0,0,0,0,0,0,0,0,0
505021088,1300,3211,115,1953,2574,4642,484,821,1305,1623
505021089,1702,3719,141,1960,2785,4886,557,945,1502,1327
505021090,1603,2523,142,2063,2750,4955,236,707,943,1758
505021091,0,0,0,0,0,0,0,0,0,0
505021092,1449,3207,114,1978,2610,4702,444,805,1249,1486
505021093,1113,2345,96,1542,2066,3704,211,646,857,1040
505021094,663,1503,57,784,1130,1971,191,338,529,512
505021095,1030,2435,105,1393,1794,3292,251,620,871,1032
505021096,1133,3149,100,907,1393,2400,442,1038,1480,767
505021097,1319,2902,118,1633,2206,3957,384,772,1156,1505
505031098,709,797,138,1531,2049,3718,79,172,251,822
505031099,1582,1438,260,3596,4649,8505,200,232,432,2251
505031100,1382,1471,179,2738,3441,6358,184,290,474,963
505031101,1035,1173,167,2101,2727,4995,136,265,401,940
505031102,443,547,128,1125,1531,2784,33,98,131,713
505031103,1986,3054,253,3297,4349,7899,291,635,926,1364
505031104,638,755,105,1398,1876,3379,86,123,209,847
505031105,1559,1763,171,3148,4009,7328,243,404,647,1319
505031106,0,0,0,0,0,0,0,0,0,0
505031107,1055,1335,123,2125,2696,4944,148,254,402,750
505031108,1860,2424,245,4356,5542,10143,295,452,747,1694
505031255,703,742,110,1488,1848,3446,83,126,209,632
505031256,41,63,9,107,141,257,5,3,8,102
505031257,197,147,41,564,701,1306,32,20,52,338
505031258,632,512,97,1545,2012,3654,67,83,150,973
506011110,1057,983,300,2803,3737,6840,99,246,345,2040
506011111,0,0,0,0,0,0,0,0,0,0
506011112,332,331,49,911,1163,2123,44,67,111,425
506011113,1602,2970,172,2546,3257,5975,298,930,1228,773
506011114,711,793,146,1649,2163,3958,106,176,282,1048
506011115,628,691,84,1452,1878,3414,101,149,250,591
506011116,642,813,69,1199,1541,2809,122,159,281,431
506011117,675,578,131,1712,2164,4007,36,123,159,673
506021118,1065,1664,109,1939,2519,4567,195,429,624,1680
506021119,1246,3083,102,1722,2300,4124,380,952,1332,1826
506021120,0,0,0,0,0,0,0,0,0,0
506021121,0,0,0,0,0,0,0,0,0,27
506021122,1835,3448,204,3101,4007,7312,332,969,1301,2940
506021123,1353,2929,112,1517,1980,3609,338,1017,1355,1380
506031124,1528,3399,149,1740,2417,4306,331,1130,1461,2580
506031125,795,1496,108,1171,1550,2829,194,438,632,467
506031126,0,0,0,0,0,0,0,0,0,0
506031127,1437,2963,153,1820,2476,4449,236,977,1213,1454
506031128,1034,1892,123,1911,2477,4511,228,502,730,918
506031129,1077,2612,87,1137,1669,2893,303,916,1219,830
506031130,0,0,0,0,0,0,0,0,0,6
506031131,1470,3264,140,1639,2251,4030,370,1100,1470,835
506041132,1194,1975,183,2453,3236,5872,149,588,737,1364
506041133,1591,3306,191,2420,3189,5800,265,1118,1383,2093
506041134,1146,1230,289,2983,3848,7120,104,300,404,1972
506041135,1363,2029,211,2639,3397,6247,195,595,790,923
506041136,885,973,187,1911,2531,4629,83,259,342,1208
506041137,1674,2170,260,3401,4444,8105,273,497,770,1526
506051138,1261,1656,193,2977,3826,6996,173,384,557,1259
506051139,765,845,119,2147,2666,4932,131,122,253,987
506051140,1379,1888,132,2185,2914,5231,303,459,762,1099
506051141,974,1354,107,1714,2241,4062,249,311,560,824
506061142,1145,1023,192,3011,3681,6884,136,218,354,936
506061143,373,412,84,1169,1480,2733,79,76,155,427
506061144,268,277,44,767,972,1783,43,32,75,742
506071145,1156,3274,94,1250,1709,3053,415,1039,1454,1224
506071146,839,2134,68,825,1220,2113,289,800,1089,988
506071147,1315,3801,110,1173,1750,3033,500,1395,1895,1605
507011148,1327,2315,178,2386,3091,5655,293,600,893,876
507011150,0,0,0,0,0,0,0,0,0,0
507011151,0,0,0,0,0,0,0,0,0,0
507011152,668,883,70,1501,1894,3465,110,148,258,605
507011153,556,980,86,1155,1543,2784,134,246,380,680
507011154,731,1177,110,1460,1915,3485,188,304,492,1216
507011155,0,0,0,3,3,6,0,0,0,3
507011158,261,434,12,315,389,716,53,131,184,278
507011159,771,1362,114,1724,2256,4094,189,317,506,899
507011160,652,830,103,1675,2190,3968,108,153,261,1060
507011161,1182,2024,144,2020,2632,4796,230,553,783,961
507011163,495,619,83,1322,1638,3043,101,122,223,599
507011259,597,870,91,1296,1660,3047,102,181,283,560
507011260,220,369,19,344,440,803,50,62,112,181
507021164,631,1614,44,603,895,1542,257,496,753,587
507021165,1156,3067,75,1329,1815,3219,489,1172,1661,1891
507021166,1048,2439,86,1584,2175,3845,381,794,1175,1320
507021167,0,0,0,3,3,6,0,0,0,0
507031169,1036,1653,153,2018,2540,4711,199,464,663,847
507031170,385,397,125,1180,1566,2871,48,70,118,831
507031172,0,3,0,15,17,32,0,0,0,7
507031173,0,0,0,6,8,14,0,0,0,3
507031174,546,502,145,1658,2225,4028,55,101,156,1234
507031261,355,609,59,965,1189,2213,84,128,212,1295
507041175,945,2546,63,803,1171,2037,344,847,1191,813
507041176,309,814,12,329,470,811,77,246,323,200
507041177,1146,2467,97,1570,2098,3765,414,627,1041,1137
507041178,1251,3096,84,1190,1738,3012,423,982,1405,970
507041179,646,1497,42,644,936,1622,234,506,740,528
507041180,1022,1949,81,1206,1655,2942,267,502,769,467
507041181,1360,2961,98,1676,2354,4128,407,754,1161,1138
507041182,1060,2170,114,1288,1808,3210,238,577,815,1094
507041183,348,649,46,572,782,1400,100,118,218,426
507041184,496,1359,34,425,640,1099,151,374,525,303
507051185,2364,2348,413,5893,7411,13717,299,393,692,2630
507051186,476,333,163,1558,1973,3694,59,60,119,797
507051187,973,688,183,2399,3064,5646,91,118,209,1187
507051188,1007,896,184,2820,3593,6597,113,177,290,2091
507051189,0,0,0,0,0,0,0,0,0,3
507051190,921,840,159,2068,2683,4910,135,179,314,1110
507051191,1424,1462,215,3589,4394,8198,217,227,444,1245
507051192,823,717,135,2313,2900,5348,101,104,205,1019
507051193,659,536,135,2014,2506,4655,83,81,164,924
509011225,1119,1332,191,2106,2844,5141,256,257,513,1408
509011226,258,322,47,535,739,1321,51,57,108,294
509011227,366,381,74,771,1033,1878,79,57,136,343
509011228,478,664,64,827,1157,2048,123,178,301,652
509011229,150,200,38,376,505,919,28,6,34,350
509011230,171,254,61,575,753,1389,40,25,65,624
509011231,205,304,47,519,718,1284,33,24,57,495
509011232,264,328,43,550,701,1294,56,57,113,674
509011233,607,513,170,1868,2364,4402,64,45,109,896
509011234,344,316,78,764,1021,1863,52,43,95,628
509011235,0,0,0,0,0,0,0,0,0,0
509021236,364,273,53,1013,1268,2334,37,41,78,589
509021237,172,219,42,526,680,1248,18,19,37,520
509021238,177,215,51,551,697,1299,36,27,63,401
509021239,479,493,91,1420,1879,3390,50,65,115,994
509021240,228,308,71,636,836,1543,52,19,71,519
509021241,231,289,46,601,785,1432,32,28,60,502
509021242,134,172,31,419,549,999,15,12,27,426
509021243,578,536,181,1611,2164,3956,75,98,173,1700
509021244,334,272,47,781,1010,1838,51,76,127,524
509021245,358,384,46,763,1020,1829,43,51,94,723
509031246,186,188,40,465,596,1101,29,22,51,495
509031247,223,327,43,533,720,1296,43,14,57,432
509031248,147,168,14,389,482,885,21,26,47,279
509031249,262,313,93,618,884,1595,53,46,99,598
509031250,249,280,44,648,870,1562,54,28,82,567
510011262,950,1441,198,2015,2729,4942,218,305,523,1870
510011263,230,388,162,730,1037,1929,94,110,204,1300
510011264,66,134,28,202,299,529,16,39,55,753
510011265,365,597,100,921,1239,2260,96,86,182,997
510011266,48,92,77,236,333,646,26,3,29,266
510021267,276,340,84,1531,1754,3369,35,52,87,1616
510021268,225,301,49,872,1028,1949,33,44,77,701
510021269,324,428,37,845,1000,1882,66,105,171,575
510021270,492,527,129,1677,2014,3820,86,85,171,1384
510031271,764,972,114,3617,4062,7793,93,173,266,2269
510031272,988,1353,222,2784,3535,6541,165,251,416,1818
510031273,282,330,50,1117,1304,2471,28,69,97,1025
511011274,639,675,195,1838,2428,4461,137,87,224,1546
511011275,205,251,49,470,683,1202,25,16,41,544
511021276,214,297,70,662,886,1618,34,30,64,809
511021277,270,371,71,779,1058,1908,40,58,98,507
511031278,254,203,91,1198,1484,2773,17,42,59,969
511031279,654,1003,164,2285,2858,5307,127,251,378,1481
511031280,524,836,85,1483,1769,3337,94,194,288,721
511031281,0,0,0,0,0,0,0,0,0,3
511031282,178,177,42,698,891,1631,29,32,61,642
511031283,135,205,33,582,761,1376,41,52,93,977
511031284,0,0,0,0,0,0,0,0,0,0
511041285,661,774,178,1735,2252,4165,137,144,281,1523
511041286,352,252,151,1319,1711,3181,55,19,74,1054
511041287,487,462,101,1468,1820,3389,88,56,144,585
511041288,647,814,163,1630,2071,3864,154,166,320,706
511041289,211,156,59,625,852,1536,22,22,44,367
511041290,132,188,39,414,548,1001,25,28,53,696
511041291,203,233,59,580,772,1411,23,15,38,434
511041292,313,338,73,866,1139,2078,34,38,72,748
597979799,62,26,6,123,153,282,0,10,10,87
599999499,299,511,58,965,1252,2275,49,115,164,1671
601011001,178,110,138,736,1071,1945,8,8,16,868
601011002,243,160,87,1044,1300,2431,34,21,55,380
601011003,305,316,39,820,1107,1966,48,52,100,305
601021004,506,834,64,774,1075,1913,172,248,420,407
601021005,615,941,61,1305,1609,2975,180,234,414,362
601021006,271,365,24,504,662,1190,79,95,174,163
601021007,923,1299,77,1495,1943,3515,243,321,564,675
601021008,562,1103,58,875,1235,2168,179,272,451,568
601021009,229,256,75,665,883,1623,33,42,75,446
601021010,79,54,46,336,515,897,0,10,10,773
601021011,253,233,90,923,1255,2268,38,46,84,504
601021012,327,529,31,758,948,1737,87,161,248,284
601031013,281,223,40,743,932,1715,35,43,78,226
601031014,267,285,67,925,1191,2183,45,49,94,510
601031015,350,257,115,1367,1683,3165,49,87,136,635
601031016,192,279,47,633,811,1491,55,71,126,354
601031017,562,503,173,1560,2122,3855,87,135,222,1090
601031018,287,293,88,777,976,1841,41,72,113,508
601031019,293,483,73,757,986,1816,85,106,191,480
601031020,280,207,111,1043,1362,2516,34,31,65,587
601031021,225,405,46,534,695,1275,47,106,153,310
601041022,784,1413,109,1515,2001,3625,204,423,627,753
601041023,858,1521,113,1326,1830,3269,251,517,768,619
601041024,585,881,88,1171,1504,2763,150,256,406,471
601041025,0,0,0,0,0,0,0,0,0,0
601041026,313,830,15,249,364,628,135,297,432,183
601051027,556,1752,71,650,920,1641,242,687,929,864
601051028,610,1586,72,899,1174,2145,287,514,801,597
601051029,316,971,33,314,432,779,193,460,653,266
601051030,405,1014,70,623,866,1559,183,351,534,506
601051031,862,2795,55,653,1006,1714,360,1418,1778,885
601051032,397,1382,37,443,609,1089,268,622,890,439
601051033,393,1324,38,484,608,1130,285,555,840,347
601061034,515,515,108,1416,1803,3327,73,120,193,638
601061035,544,563,125,1459,1836,3420,85,123,208,693
602011036,168,286,46,399,531,976,24,69,93,310
602011037,245,341,56,656,832,1544,34,69,103,404
602011038,371,924,40,507,702,1249,117,300,417,625
602011039,262,368,40,705,902,1647,54,88,142,338
602011040,177,236,75,455,636,1166,21,60,81,358
602011041,380,480,159,1115,1546,2820,46,135,181,833
602011042,359,685,55,575,772,1402,94,184,278,374
602011043,285,451,40,508,696,1244,65,76,141,307
602011044,421,517,67,1015,1346,2428,53,100,153,506
602011045,114,74,56,442,638,1136,0,0,0,395
602011046,480,799,89,981,1316,2386,112,182,294,425
602011047,252,552,66,615,843,1524,72,101,173,429
602011048,250,318,52,848,1051,1951,34,43,77,341
602011049,348,729,63,585,784,1432,115,215,330,276
602011050,155,189,41,563,729,1333,14,31,45,306
602011051,302,661,25,542,712,1279,113,146,259,289
602011052,299,333,54,762,986,1802,56,55,111,367
602021053,232,181,62,612,795,1469,34,47,81,461
602021054,326,407,64,799,1119,1982,46,64,110,576
602021055,421,517,54,940,1244,2238,87,138,225,579
602021056,205,216,59,612,798,1469,22,24,46,204
602021057,262,308,50,581,820,1451,47,46,93,392
602031058,241,373,62,656,898,1616,53,94,147,365
602031059,331,304,110,1047,1349,2506,37,62,99,766
602031060,218,250,54,600,850,1504,29,51,80,404
602031061,206,183,38,446,610,1094,22,35,57,445
602031062,306,327,60,858,1121,2039,48,92,140,484
602031064,326,399,84,1007,1321,2412,58,78,136,681
602031099,76,87,12,160,191,363,10,31,41,93
602031100,307,316,95,1007,1292,2394,23,51,74,655
603011065,88,106,30,266,389,685,17,27,44,193
603011066,180,129,36,513,673,1222,36,46,82,314
603011067,245,260,83,962,1242,2287,31,38,69,600
603011068,0,0,0,3,3,6,0,0,0,0
603021069,268,397,18,425,552,995,71,168,239,323
603021070,321,469,43,599,828,1470,85,133,218,410
603021071,254,240,60,506,744,1310,39,80,119,384
603021072,558,726,108,1273,1713,3094,116,175,291,708
603031073,155,156,22,369,495,886,27,52,79,356
603031074,347,310,65,694,913,1672,34,63,97,579
604011075,122,111,51,538,685,1274,14,9,23,285
604011076,276,289,61,885,1160,2106,47,61,108,495
604011077,199,221,88,594,796,1478,36,55,91,324
604011078,397,453,83,882,1166,2131,71,117,188,505
604011079,327,378,59,824,1119,2002,56,70,126,524
604011080,192,167,66,644,826,1536,25,22,47,226
604011081,213,206,52,627,863,1542,34,31,65,389
604011082,419,448,91,1128,1480,2699,67,92,159,598
604011083,204,198,62,701,879,1642,33,60,93,335
604011084,322,310,99,992,1324,2415,58,60,118,591
604021085,834,810,259,2131,2843,5233,136,137,273,1352
604021086,190,195,67,677,929,1673,35,33,68,480
604021087,200,223,82,774,954,1810,21,28,49,433
604021088,238,255,32,650,774,1456,26,44,70,199
604021089,407,430,56,984,1295,2335,65,83,148,511
604021090,189,163,37,622,758,1417,26,6,32,182
604021091,394,372,81,1003,1315,2399,56,54,110,627
604021092,202,348,43,545,673,1261,49,47,96,207
604031093,95,116,6,274,336,616,9,15,24,184
604031094,197,161,48,609,761,1418,20,14,34,416
604031095,166,140,71,601,785,1457,12,13,25,374
604031096,257,259,56,626,805,1487,52,58,110,285
604031097,168,181,55,686,884,1625,19,40,59,439
604031098,0,0,0,0,0,0,0,0,0,0
697979799,6,3,0,23,21,44,0,0,0,4
699999499,54,77,10,119,157,286,9,38,47,201
701011001,0,0,0,0,0,0,0,0,0,0
701011002,570,1267,42,820,1053,1915,134,448,582,1154
701011003,0,0,0,0,0,0,0,0,0,0
701011004,298,568,3,397,497,897,119,221,340,394
701011005,291,698,32,442,588,1062,100,211,311,535
701011006,136,276,18,350,469,837,45,85,130,311
701011007,223,483,13,340,410,763,85,168,253,308
701011008,303,687,50,622,775,1447,103,175,278,558
701011009,257,442,16,508,558,1082,47,125,172,270
701021010,135,263,13,226,321,560,49,97,146,221
701021011,159,233,20,368,473,861,44,68,112,202
701021012,66,92,6,170,207,383,9,21,30,190
701021013,243,654,23,344,445,812,74,277,351,439
701021014,0,0,0,0,0,0,0,0,0,0
701021015,0,0,0,0,0,0,0,0,0,0
701021016,184,447,45,333,434,812,59,136,195,426
701021017,0,0,0,0,0,0,0,0,0,0
701021018,93,232,14,186,256,456,49,74,123,151
701021019,253,397,40,619,817,1476,62,100,162,593
701021020,346,562,38,667,826,1531,90,133,223,376
701021021,359,651,24,592,726,1342,83,251,334,290
701021022,275,457,55,682,861,1598,79,126,205,531
701021023,156,321,32,330,444,806,53,118,171,290
701021024,114,208,14,268,337,619,37,68,105,203
701021025,267,701,30,432,595,1057,112,298,410,443
701021026,229,616,23,329,429,781,99,263,362,411
701021027,161,397,7,287,384,678,62,142,204,300
701021028,126,227,8,221,301,530,41,76,117,229
701021029,128,235,19,229,266,514,53,87,140,180
701021030,163,267,35,335,459,829,41,56,97,220
701031031,312,360,45,1389,1577,3011,48,64,112,2535
701031032,569,513,105,1805,2217,4127,105,88,193,1019
701031033,0,0,0,0,0,0,0,0,0,0
701031034,220,214,42,750,918,1710,37,29,66,383
701031035,240,218,60,869,1068,1997,39,51,90,784
701041036,195,211,38,621,768,1427,39,38,77,202
701041037,200,212,48,488,575,1111,39,57,96,326
701041038,358,427,65,754,916,1735,68,81,149,299
701041039,167,228,40,472,639,1151,38,38,76,412
701041040,130,118,50,435,564,1049,22,3,25,340
701041041,357,302,46,817,986,1849,66,68,134,358
701041042,201,304,59,554,688,1301,33,79,112,226
701041043,487,545,69,1250,1556,2875,70,122,192,474
701041044,169,180,66,602,707,1375,30,24,54,357
702011045,273,392,50,581,749,1380,83,122,205,580
702011046,320,644,48,594,753,1395,158,290,448,612
702011047,281,476,31,549,719,1299,73,117,190,553
702011048,343,495,50,697,859,1606,101,180,281,476
702011049,299,559,36,421,544,1001,81,164,245,524
702011050,147,192,44,304,426,774,17,39,56,633
702011051,129,167,19,359,451,829,34,53,87,381
702011052,38,68,76,165,410,651,6,24,30,1135
702011053,38,81,43,96,182,321,7,26,33,507
702011054,29,45,7,56,83,146,7,6,13,202
702021055,34,71,48,217,319,584,7,9,16,263
702021056,148,194,24,311,397,732,40,52,92,450
702031057,222,292,80,628,858,1566,41,90,131,800
702031058,34,62,65,145,225,435,3,13,16,226
702031059,15,41,52,60,138,250,16,14,30,416
702031060,16,69,17,115,176,308,13,7,20,255
702031061,63,86,43,187,477,707,14,17,31,786
702041062,62,138,12,166,332,510,12,34,46,482
702041063,82,115,204,262,541,1007,35,48,83,981
702041064,182,271,19,479,602,1100,74,78,152,482
702051065,45,60,77,151,271,499,3,7,10,369
702051066,72,101,36,209,322,567,6,18,24,715
702051067,600,741,128,1273,1643,3044,130,155,285,1968
702051068,71,72,41,198,311,550,8,13,21,522
797979799,9,20,0,13,20,33,0,0,0,3
799999499,116,179,28,315,447,790,32,48,80,863
801011001,149,549,13,96,159,268,143,369,512,110
801011002,421,1703,39,440,633,1112,175,888,1063,630
801011003,449,1767,41,400,539,980,263,844,1107,614
801011004,223,294,38,432,590,1060,50,79,129,211
801011005,168,654,6,172,283,461,147,439,586,112
801011006,597,842,66,798,1053,1917,149,301,450,302
801011007,416,781,44,584,778,1406,145,308,453,401
801011008,274,801,28,441,630,1099,135,333,468,252
801011009,299,491,31,378,507,916,108,185,293,163
801011010,189,310,21,209,306,536,74,103,177,116
801011011,294,524,28,378,512,918,114,231,345,165
801011012,0,0,0,0,0,0,0,0,0,0
801011013,222,638,27,178,298,503,138,287,425,132
801011014,198,415,25,373,518,916,71,175,246,216
801011015,353,591,59,572,844,1475,132,234,366,321
801011016,562,1235,57,700,1005,1762,298,569,867,389
801011017,303,490,26,470,657,1153,91,171,262,228
801011018,9,15,0,6,7,13,0,18,18,3
801011019,571,972,58,849,1101,2008,161,403,564,246
801011020,153,534,20,213,303,536,112,267,379,136
801011021,176,474,14,257,356,627,102,187,289,172
801011022,277,522,34,307,439,780,107,207,314,157
801011023,233,504,6,260,420,686,99,211,310,323
801011024,204,495,26,301,419,746,84,223,307,182
801011025,217,371,33,312,428,773,60,137,197,125
801011026,194,554,9,167,243,419,129,313,442,86
801011111,0,0,0,0,0,0,0,0,0,3
801011112,0,0,0,0,0,0,0,0,0,3
801031031,0,0,0,0,0,0,0,0,0,417
801031032,3,0,0,3,3,6,0,0,0,0
801031113,45,46,6,122,165,293,6,15,21,188
801031114,3,17,0,7,16,23,0,0,0,0
801031115,11,20,0,29,24,53,0,6,6,26
801041034,477,812,45,601,801,1447,176,353,529,225
801041035,529,1037,37,532,670,1239,148,615,763,286
801041036,555,901,56,625,825,1506,160,384,544,264
801041037,343,887,21,361,441,823,137,596,733,188
801041038,355,749,9,298,397,704,126,415,541,158
801041039,454,1399,48,459,600,1107,154,779,933,291
801041040,540,1100,35,494,667,1196,157,560,717,415
801041043,15,23,0,43,46,89,14,14,28,13
801041044,591,1483,43,571,722,1336,180,899,1079,303
801041045,0,0,0,0,0,0,0,0,0,0
801041046,836,1494,103,1174,1542,2819,275,617,892,578
801041047,585,1115,44,558,828,1430,227,568,795,430
801041048,410,881,53,531,716,1300,168,434,602,316
801041116,0,0,0,0,0,0,0,0,0,0
801041117,0,0,0,0,0,0,0,0,0,0
801041118,45,116,3,60,72,135,11,59,70,11
801041119,0,0,0,0,0,0,0,0,0,0
801041120,10,9,0,0,3,3,0,7,7,6
801041121,0,0,0,0,0,0,0,0,0,0
801041122,0,0,0,0,0,0,0,0,0,0
801051049,22,399,10,20,44,74,8,228,236,135
801051050,292,1100,18,263,405,686,260,672,932,400
801051051,281,1574,21,256,360,637,256,776,1032,614
801051053,191,1019,15,92,157,264,130,530,660,467
801051054,108,545,9,111,182,302,83,311,394,160
801051055,241,724,25,269,400,694,153,416,569,245
801051056,148,659,6,156,245,407,164,430,594,157
801051057,300,1245,20,296,460,776,251,702,953,450
801051058,260,1345,19,249,370,638,259,860,1119,333
801051060,192,1095,15,148,219,382,187,797,984,444
801051061,366,1304,25,392,539,956,258,760,1018,337
801051123,0,0,0,0,0,0,0,0,0,0
801051124,190,745,9,123,224,356,172,565,737,253
801051125,86,252,25,167,209,401,8,54,62,124
801051126,0,0,0,0,0,0,0,0,0,0
801051127,85,389,6,89,128,223,76,233,309,197
801051128,0,0,0,0,0,0,0,0,0,0
801061062,186,694,3,96,186,285,151,398,549,153
801061063,109,436,0,51,101,152,68,281,349,153
801061064,280,1155,26,254,367,647,226,682,908,466
801061066,0,0,0,0,0,0,0,0,0,0
801061067,350,1119,32,412,591,1035,232,681,913,686
801061068,0,0,0,0,0,0,0,0,0,0
801061069,151,741,14,131,210,355,139,385,524,221
801061070,214,676,7,133,234,374,158,474,632,219
801061129,81,439,0,43,70,113,113,326,439,124
801061130,0,3,0,3,3,6,0,0,0,3
801061131,311,1370,10,206,299,515,268,837,1105,381
801071071,406,485,49,678,881,1608,105,109,214,252
801071072,337,547,36,451,619,1106,94,168,262,169
801071073,544,681,61,810,1082,1953,126,196,322,351
801071074,447,500,63,731,961,1755,119,172,291,273
801071075,420,539,64,686,931,1681,99,145,244,291
801071076,281,581,24,238,347,609,139,258,397,114
801071077,226,285,33,408,506,947,52,61,113,168
801071078,679,837,79,990,1290,2359,147,271,418,397
801071079,283,447,26,360,482,868,86,157,243,172
801071080,166,417,13,179,255,447,61,169,230,140
801071081,384,494,32,594,762,1388,79,121,200,277
801071082,1297,2198,130,1656,2334,4120,444,732,1176,902
801071083,129,255,4,204,242,450,47,73,120,60
801071084,500,727,48,679,962,1689,146,236,382,468
801071085,0,0,0,0,0,0,0,0,0,0
801071086,121,246,13,193,238,444,33,78,111,83
801071087,210,252,35,452,599,1086,32,68,100,177
801071088,345,381,33,549,702,1284,60,107,167,155
801071089,0,0,0,0,0,0,0,0,0,3
801071090,644,1114,68,807,1141,2016,228,408,636,418
801071132,0,0,0,0,0,0,0,0,0,0
801081091,211,587,0,174,275,449,154,278,432,124
801081092,223,534,11,281,388,680,140,272,412,157
801081093,254,488,16,300,409,725,117,208,325,205
801081094,219,526,8,216,305,529,97,210,307,123
801081095,248,501,10,287,404,701,134,186,320,205
801081096,150,337,7,202,290,499,59,155,214,195
801081097,231,452,19,255,352,626,93,193,286,134
801081098,254,673,17,266,383,666,162,306,468,376
801081133,0,0,0,0,0,0,0,0,0,0
801091099,200,506,15,187,279,481,94,208,302,147
801091100,326,1203,18,315,480,813,223,651,874,292
801091101,284,619,19,211,336,566,132,297,429,157
801091102,213,759,8,152,249,409,129,449,578,359
801091103,194,642,3,139,223,365,146,380,526,229
801091104,183,492,6,133,258,397,87,248,335,130
801091105,221,564,15,259,361,635,98,294,392,296
801091106,279,702,10,247,385,642,106,296,402,194
801091107,53,229,3,32,65,100,18,115,133,58
801091108,210,550,10,178,273,461,102,225,327,154
801091109,240,854,15,192,237,444,147,306,453,272
801091110,188,443,7,180,220,407,73,177,250,106
801101134,0,0,0,0,0,0,0,0,0,3
801101135,138,369,17,124,177,318,60,195,255,124
801101136,0,0,0,0,0,0,0,0,0,0
801101137,0,0,0,0,0,0,0,0,0,0
801101138,0,0,0,0,0,0,0,0,0,0
801101139,210,733,15,190,236,441,91,289,380,210
801111140,57,63,0,89,106,195,9,25,34,42
801111141,0,0,0,8,8,16,0,0,0,0
897979799,0,0,0,0,0,0,0,0,0,0
899999499,27,80,3,54,64,121,3,44,47,106
901011001,89,86,23,215,284,522,26,23,49,506
901021002,18,23,3,78,98,179,4,6,10,57
901031003,18,44,0,31,34,65,0,12,12,89
901041004,145,153,19,274,420,713,4,29,33,184
997979799,0,0,0,3,3,6,0,0,0,0
999999499,3,9,0,0,0,0,0,0,0,3
